//MAP CONVERTED BY dmm2tgm.py THIS HEADER COMMENT PREVENTS RECONVERSION, DO NOT REMOVE
"a" = (
/turf/simulated/wall/mineral/wood/nonmetal{
	baseturf = /turf/simulated/floor/plating/lava/smooth/lava_land_surface
	},
/area/lavaland/surface/outdoors/unexplored/danger)
"c" = (
/turf/template_noop,
/area/lavaland/surface/outdoors/unexplored/danger)
"C" = (
/turf/simulated/floor/wood/cold{
	baseturf = /turf/simulated/floor/plating/lava/smooth/lava_land_surface;
	oxygen = 14;
	nitrogen = 23;
	temperature = 300
	},
/area/lavaland/surface/outdoors/unexplored/danger)

(1,1,1) = {"
c
a
C
a
c
"}
(2,1,1) = {"
c
c
C
c
c
"}
(3,1,1) = {"
c
c
C
c
c
"}
(4,1,1) = {"
c
c
C
c
c
"}
(5,1,1) = {"
c
a
C
a
c
"}
