//MAP CONVERTED BY dmm2tgm.py THIS HEADER COMMENT PREVENTS RECONVERSION, DO NOT REMOVE
"a" = (
/obj/structure/lattice/catwalk/fireproof,
/obj/structure/marker_beacon,
/turf/simulated/floor/plating/asteroid/basalt/lava_land_surface,
/area/lavaland/surface/outdoors/unexplored/danger)
"b" = (
/obj/structure/lattice/catwalk/fireproof,
/turf/simulated/floor/plating/asteroid/basalt/lava_land_surface,
/area/lavaland/surface/outdoors/unexplored/danger)
"c" = (
/turf/template_noop,
/area/lavaland/surface/outdoors/unexplored/danger)

(1,1,1) = {"
c
a
b
a
c
"}
(2,1,1) = {"
c
c
b
c
c
"}
(3,1,1) = {"
c
c
b
c
c
"}
(4,1,1) = {"
c
c
b
c
c
"}
(5,1,1) = {"
c
a
b
a
c
"}
