//MAP CONVERTED BY dmm2tgm.py THIS HEADER COMMENT PREVENTS RECONVERSION, DO NOT REMOVE
"c" = (
/turf/template_noop,
/area/lavaland/surface/outdoors/unexplored/danger)
"q" = (
/turf/simulated/floor/wood/cold{
	baseturf = /turf/simulated/floor/plating/lava/smooth/lava_land_surface;
	oxygen = 14;
	nitrogen = 23;
	temperature = 300
	},
/area/lavaland/surface/outdoors/unexplored/danger)
"y" = (
/turf/simulated/wall/mineral/wood/nonmetal{
	baseturf = /turf/simulated/floor/plating/lava/smooth/lava_land_surface
	},
/area/lavaland/surface/outdoors/unexplored/danger)

(1,1,1) = {"
c
c
c
c
c
"}
(2,1,1) = {"
y
c
c
c
y
"}
(3,1,1) = {"
q
q
q
q
q
"}
(4,1,1) = {"
y
c
c
c
y
"}
(5,1,1) = {"
c
c
c
c
c
"}
