//MAP CONVERTED BY dmm2tgm.py THIS HEADER COMMENT PREVENTS RECONVERSION, DO NOT REMOVE
"a" = (
/turf/simulated/mineral/volcanic/lava_land_surface,
/area/lavaland/surface/outdoors)
"b" = (
/turf/simulated/floor/plating/asteroid/basalt/lava_land_surface,
/area/lavaland/surface/outdoors)
"c" = (
/obj/effect/decal/remains/human,
/turf/simulated/floor/plating/asteroid/basalt/lava_land_surface,
/area/lavaland/surface/outdoors)
"d" = (
/turf/simulated/wall/indestructible,
/area/lavaland/surface/outdoors)
"e" = (
/obj/effect/mapping_helpers/no_lava,
/obj/item/paper/monolithren,
/obj/item/grown/bananapeel/bluespace,
/mob/living/simple_animal/hostile/asteroid/goliath/beast,
/mob/living/simple_animal/hostile/asteroid/basilisk/watcher/icewing,
/obj/item/gun/energy/gun/nuclear,
/turf/simulated/floor/plating/asteroid/basalt/lava_land_surface,
/area/lavaland/surface/outdoors)
"G" = (
/turf/template_noop,
/area/template_noop)

(1,1,1) = {"
G
G
G
G
G
G
G
G
G
G
G
G
G
G
G
G
G
G
G
G
G
G
G
G
G
G
G
G
G
G
"}
(2,1,1) = {"
G
a
a
a
a
a
a
a
a
a
a
a
a
b
a
b
b
c
b
b
b
b
a
a
a
a
a
a
a
G
"}
(3,1,1) = {"
G
b
a
a
a
a
b
a
a
a
a
a
a
a
b
a
b
b
b
a
a
b
b
a
a
b
b
a
a
G
"}
(4,1,1) = {"
G
a
a
a
b
b
b
a
a
a
a
a
a
a
b
b
b
a
a
b
b
b
b
b
b
c
b
a
b
G
"}
(5,1,1) = {"
G
a
b
b
b
b
b
a
a
a
a
a
a
a
a
a
b
b
b
b
b
b
b
b
b
b
b
a
a
G
"}
(6,1,1) = {"
G
a
a
a
a
a
a
a
a
a
a
a
a
b
b
b
b
b
b
b
b
b
b
b
b
b
b
b
a
G
"}
(7,1,1) = {"
G
a
a
a
a
a
a
a
a
a
b
b
b
b
b
b
b
c
b
b
c
c
b
b
c
b
b
b
b
G
"}
(8,1,1) = {"
G
a
a
a
a
a
a
a
a
a
b
c
b
b
b
b
c
b
b
b
b
c
b
b
b
b
b
c
b
G
"}
(9,1,1) = {"
G
a
b
a
a
a
a
a
a
a
b
b
b
b
c
b
b
b
b
b
b
b
b
b
b
b
b
b
b
G
"}
(10,1,1) = {"
G
a
a
a
a
a
a
a
a
a
a
a
b
b
b
c
b
c
b
c
b
b
b
b
b
b
c
b
b
G
"}
(11,1,1) = {"
G
a
a
b
a
a
a
a
a
a
a
a
a
b
b
b
b
b
b
b
b
b
b
c
b
b
b
b
b
G
"}
(12,1,1) = {"
G
a
b
a
a
a
b
b
a
a
c
b
b
c
b
b
c
b
c
b
b
b
b
b
b
b
b
b
b
G
"}
(13,1,1) = {"
G
a
b
b
b
b
b
b
b
b
d
d
d
d
d
d
d
b
b
b
b
b
b
b
b
b
b
b
c
G
"}
(14,1,1) = {"
G
a
b
c
b
b
b
b
c
b
d
d
d
d
d
d
d
b
b
b
b
b
c
b
b
b
b
b
b
G
"}
(15,1,1) = {"
G
a
b
b
b
b
c
b
b
b
d
d
d
d
d
d
d
c
b
b
c
b
a
b
b
b
c
b
b
G
"}
(16,1,1) = {"
G
a
b
b
b
b
b
b
b
b
d
d
d
e
d
d
d
b
a
a
b
b
a
a
b
b
b
b
b
G
"}
(17,1,1) = {"
G
a
b
c
b
b
b
c
b
b
d
d
d
d
d
d
d
c
a
a
a
a
a
a
a
b
b
a
b
G
"}
(18,1,1) = {"
G
a
b
a
a
a
b
b
b
b
d
d
d
d
d
d
d
c
b
a
a
a
a
a
b
b
b
c
a
G
"}
(19,1,1) = {"
G
a
b
a
a
a
b
b
b
b
d
d
d
d
d
d
d
b
b
a
a
a
a
a
b
a
b
b
a
G
"}
(20,1,1) = {"
G
a
b
b
b
b
b
b
c
b
b
b
c
b
b
c
b
b
a
a
a
a
a
a
a
a
a
a
a
G
"}
(21,1,1) = {"
G
a
b
b
b
b
b
b
b
b
b
b
b
c
b
b
b
b
b
a
a
a
a
a
a
a
a
a
a
G
"}
(22,1,1) = {"
G
a
b
b
b
b
a
b
b
b
a
b
b
b
b
b
b
b
b
b
a
a
a
a
a
a
a
a
a
G
"}
(23,1,1) = {"
G
a
a
a
a
a
b
b
b
b
b
b
b
b
b
b
c
b
b
a
a
a
a
a
a
a
a
a
a
G
"}
(24,1,1) = {"
G
a
a
a
a
a
c
b
b
b
b
b
b
b
c
b
b
b
b
a
a
a
a
a
a
a
a
a
a
G
"}
(25,1,1) = {"
G
a
b
b
b
b
b
b
b
b
b
b
b
c
b
b
a
a
a
a
a
a
a
a
a
a
a
a
a
G
"}
(26,1,1) = {"
G
b
b
b
b
b
b
b
b
b
c
b
b
b
b
b
a
a
a
a
a
b
a
a
a
a
a
a
a
G
"}
(27,1,1) = {"
G
b
b
a
a
a
a
a
a
a
a
b
c
b
b
a
b
b
b
b
b
b
a
a
a
a
a
a
a
G
"}
(28,1,1) = {"
G
b
b
a
a
a
a
a
a
a
a
b
b
b
b
b
b
b
b
b
b
b
c
b
b
b
b
b
b
G
"}
(29,1,1) = {"
G
a
a
a
a
a
a
a
a
a
a
b
b
b
b
b
b
b
b
b
a
a
a
a
b
a
b
b
b
G
"}
(30,1,1) = {"
G
G
G
G
G
G
G
G
G
G
G
G
G
G
G
G
G
G
G
G
G
G
G
G
G
G
G
G
G
G
"}
