//MAP CONVERTED BY dmm2tgm.py THIS HEADER COMMENT PREVENTS RECONVERSION, DO NOT REMOVE
"a" = (
/turf/template_noop,
/area/template_noop)
"d" = (
/obj/structure/chair/wood,
/turf/simulated/floor/wood{
	oxygen = 14;
	nitrogen = 23;
	temperature = 300
	},
/area/ruin/unpowered/misc_lavaruin)
"e" = (
/turf/simulated/floor/lava/lava_land_surface,
/area/ruin/unpowered/misc_lavaruin)
"f" = (
/obj/structure/chair/comfy/beige{
	dir = 1
	},
/turf/simulated/floor/wood,
/area/ruin/unpowered/misc_lavaruin)
"h" = (
/turf/simulated/floor/wood,
/area/ruin/unpowered/misc_lavaruin)
"i" = (
/obj/machinery/computer/security/wooden_tv{
	network = list("SS13","Research Outpost","Mining Outpost")
	},
/turf/simulated/floor/wood,
/area/ruin/unpowered/misc_lavaruin)
"k" = (
/turf/simulated/wall/indestructible,
/area/ruin/unpowered/misc_lavaruin)
"m" = (
/turf/simulated/floor/wood{
	oxygen = 14;
	nitrogen = 23;
	temperature = 300
	},
/area/ruin/unpowered/misc_lavaruin)
"p" = (
/obj/machinery/door/airlock/wood/glass,
/turf/simulated/floor/wood{
	oxygen = 14;
	nitrogen = 23;
	temperature = 300
	},
/area/ruin/unpowered/misc_lavaruin)
"q" = (
/obj/machinery/door/airlock/wood/glass,
/turf/simulated/floor/wood,
/area/ruin/unpowered/misc_lavaruin)
"t" = (
/obj/machinery/vending/cola/free,
/turf/simulated/floor/wood{
	oxygen = 14;
	nitrogen = 23;
	temperature = 300
	},
/area/ruin/unpowered/misc_lavaruin)
"y" = (
/obj/effect/spawner/random_spawners/dirt_50,
/turf/simulated/floor/wood,
/area/ruin/unpowered/misc_lavaruin)
"z" = (
/turf/simulated/floor/sepia{
	slowdown = 10
	},
/area/ruin/unpowered/misc_lavaruin)
"E" = (
/obj/machinery/door/airlock/wood/glass,
/obj/structure/fans/tiny,
/turf/simulated/floor/wood{
	oxygen = 14;
	nitrogen = 23;
	temperature = 300
	},
/area/ruin/unpowered/misc_lavaruin)
"I" = (
/obj/structure/table/wood,
/obj/item/reagent_containers/food/drinks/cans/beer{
	pixel_x = -9;
	pixel_y = 11
	},
/obj/item/reagent_containers/food/drinks/cans/beer{
	pixel_x = 10;
	pixel_y = -1
	},
/turf/simulated/floor/wood{
	oxygen = 14;
	nitrogen = 23;
	temperature = 300
	},
/area/ruin/unpowered/misc_lavaruin)
"J" = (
/obj/effect/baseturf_helper/lava_land/surface,
/turf/simulated/floor/carpet/green,
/area/ruin/unpowered/misc_lavaruin)
"L" = (
/obj/structure/table/wood,
/obj/item/flashlight/lamp,
/obj/item/reagent_containers/food/snacks/grown/citrus/orange,
/turf/simulated/floor/wood,
/area/ruin/unpowered/misc_lavaruin)
"N" = (
/obj/structure/bed,
/obj/item/bedsheet/centcom,
/turf/simulated/floor/wood,
/area/ruin/unpowered/misc_lavaruin)
"P" = (
/obj/effect/mapping_helpers/no_lava,
/turf/simulated/floor/plating/asteroid/basalt/lava_land_surface,
/area/lavaland/surface/outdoors)
"Q" = (
/obj/structure/chair/wood{
	dir = 1
	},
/turf/simulated/floor/wood{
	oxygen = 14;
	nitrogen = 23;
	temperature = 300
	},
/area/ruin/unpowered/misc_lavaruin)
"Y" = (
/obj/structure/table/wood,
/obj/item/paper/fluff/stations/lavaland/sloth/note,
/obj/item/flashlight/lamp,
/turf/simulated/floor/wood{
	oxygen = 14;
	nitrogen = 23;
	temperature = 300
	},
/area/ruin/unpowered/misc_lavaruin)
"Z" = (
/obj/machinery/vending/snack/free,
/turf/simulated/floor/wood,
/area/ruin/unpowered/misc_lavaruin)

(1,1,1) = {"
a
a
a
a
a
a
a
a
a
a
a
a
a
a
a
a
a
a
a
a
a
a
a
a
a
a
a
a
a
"}
(2,1,1) = {"
a
e
e
e
e
e
e
e
e
e
e
e
e
e
e
e
e
e
e
e
e
e
e
e
e
e
e
e
a
"}
(3,1,1) = {"
a
e
k
k
k
k
k
k
k
k
k
k
k
k
k
k
k
k
k
k
k
k
k
k
k
k
k
e
a
"}
(4,1,1) = {"
a
e
k
z
z
z
z
k
z
z
z
k
z
z
z
z
z
z
z
z
z
z
k
t
m
Y
k
e
P
"}
(5,1,1) = {"
a
e
k
z
k
z
k
k
k
z
k
k
k
k
k
k
k
k
k
k
k
z
E
m
m
J
p
P
P
"}
(6,1,1) = {"
a
e
k
z
k
z
z
z
z
z
z
z
z
z
z
k
z
z
z
z
k
z
k
d
I
Q
k
e
P
"}
(7,1,1) = {"
a
e
k
z
k
z
k
k
k
k
k
k
k
z
k
k
k
k
k
z
k
z
k
k
k
k
k
e
a
"}
(8,1,1) = {"
a
e
k
z
k
z
k
z
z
z
z
k
z
z
z
z
z
z
k
z
k
z
k
e
e
e
e
e
a
"}
(9,1,1) = {"
a
e
k
z
k
z
k
z
k
k
k
k
k
k
k
k
k
z
k
z
z
z
k
e
a
a
a
a
a
"}
(10,1,1) = {"
a
e
k
z
k
z
k
z
z
z
z
z
z
z
z
z
k
z
k
z
k
z
k
e
a
a
a
a
a
"}
(11,1,1) = {"
a
e
k
z
k
k
k
z
k
z
k
k
k
k
k
z
k
z
k
k
k
z
k
e
a
a
a
a
a
"}
(12,1,1) = {"
a
e
k
z
z
z
k
z
k
z
k
i
h
f
k
z
z
z
k
z
k
z
k
e
a
a
a
a
a
"}
(13,1,1) = {"
a
e
k
z
k
z
k
z
k
z
q
h
y
L
k
z
k
z
k
z
k
z
k
e
a
a
a
a
a
"}
(14,1,1) = {"
a
e
k
k
k
z
k
z
k
k
k
Z
h
N
k
z
k
k
k
z
k
z
k
e
a
a
a
a
a
"}
(15,1,1) = {"
a
e
k
z
z
z
k
z
k
z
k
k
k
k
k
z
k
z
k
z
k
z
k
e
a
a
a
a
a
"}
(16,1,1) = {"
a
e
k
z
k
z
k
z
k
z
z
z
z
z
z
z
k
z
k
z
k
z
k
e
a
a
a
a
a
"}
(17,1,1) = {"
a
e
k
z
k
k
k
z
k
k
k
k
k
k
k
k
k
z
k
z
k
z
k
e
a
a
a
a
a
"}
(18,1,1) = {"
a
e
k
z
k
z
k
z
z
k
z
z
z
z
z
z
z
z
k
z
k
z
k
e
a
a
a
a
a
"}
(19,1,1) = {"
a
e
k
z
k
z
k
k
k
k
k
z
k
k
k
k
k
k
k
z
k
z
k
e
a
a
a
a
a
"}
(20,1,1) = {"
a
e
k
z
k
z
z
z
z
z
z
z
z
z
z
z
z
z
z
z
k
z
k
e
a
a
a
a
a
"}
(21,1,1) = {"
a
e
k
z
k
k
k
k
z
k
k
k
k
k
k
k
z
k
k
k
k
z
k
e
a
a
a
a
a
"}
(22,1,1) = {"
a
e
k
z
z
z
z
z
z
z
z
k
z
z
z
z
z
z
z
z
z
z
k
e
a
a
a
a
a
"}
(23,1,1) = {"
a
e
k
k
k
k
k
k
k
k
k
k
k
k
k
k
k
k
k
k
k
k
k
e
a
a
a
a
a
"}
(24,1,1) = {"
a
e
e
e
e
e
e
e
e
e
e
e
e
e
e
e
e
e
e
e
e
e
e
e
a
a
a
a
a
"}
(25,1,1) = {"
a
a
a
a
a
a
a
a
a
a
a
a
a
a
a
a
a
a
a
a
a
a
a
a
a
a
a
a
a
"}
