//MAP CONVERTED BY dmm2tgm.py THIS HEADER COMMENT PREVENTS RECONVERSION, DO NOT REMOVE
"a" = (
/turf/simulated/floor/plating/asteroid/basalt/lava_land_surface,
/area/lavaland/surface/outdoors)
"b" = (
/turf/simulated/mineral/volcanic/lava_land_surface,
/area/lavaland/surface/outdoors)
"d" = (
/obj/effect/baseturf_helper/lava_land/surface,
/turf/simulated/floor/mineral/silver,
/area/ruin/powered/pride)
"e" = (
/obj/structure/mirror{
	pixel_x = -32
	},
/turf/simulated/floor/mineral/silver,
/area/ruin/powered/pride)
"f" = (
/obj/structure/mirror{
	pixel_x = 32
	},
/turf/simulated/floor/mineral/silver,
/area/ruin/powered/pride)
"g" = (
/turf/simulated/floor/mineral/silver,
/area/ruin/powered/pride)
"j" = (
/obj/structure/mirror{
	pixel_x = -32
	},
/obj/machinery/light/small{
	dir = 1
	},
/turf/simulated/floor/mineral/silver,
/area/ruin/powered/pride)
"k" = (
/obj/structure/mirror{
	pixel_x = 32
	},
/obj/machinery/light/small{
	dir = 1
	},
/turf/simulated/floor/mineral/silver,
/area/ruin/powered/pride)
"l" = (
/obj/structure/mirror{
	pixel_x = -32
	},
/obj/machinery/light/small{
	brightness_range = 3;
	dir = 8
	},
/turf/simulated/floor/mineral/silver,
/area/ruin/powered/pride)
"m" = (
/obj/structure/mirror{
	pixel_x = 32
	},
/obj/machinery/light/small{
	dir = 4
	},
/turf/simulated/floor/mineral/silver,
/area/ruin/powered/pride)
"r" = (
/obj/machinery/light/small,
/turf/simulated/floor/mineral/silver,
/area/ruin/powered/pride)
"y" = (
/obj/machinery/door/airlock/diamond,
/obj/structure/fans/tiny/invisible,
/turf/simulated/floor/mineral/silver,
/area/ruin/powered/pride)
"G" = (
/turf/simulated/wall/mineral/diamond,
/area/ruin/powered/pride)
"O" = (
/obj/structure/mirror/magic/pride,
/turf/simulated/wall/mineral/diamond,
/area/ruin/powered/pride)
"S" = (
/turf/simulated/floor/lava/lava_land_surface,
/area/lavaland/surface/outdoors)
"Z" = (
/obj/effect/mapping_helpers/no_lava,
/turf/simulated/floor/plating/asteroid/basalt/lava_land_surface,
/area/lavaland/surface/outdoors)

(1,1,1) = {"
a
a
a
a
a
a
a
a
a
a
a
a
a
a
a
a
a
a
a
a
"}
(2,1,1) = {"
a
a
S
S
S
S
S
S
S
S
S
S
S
S
S
S
S
S
S
Z
"}
(3,1,1) = {"
b
S
S
G
G
G
G
G
G
G
G
G
G
G
G
G
G
G
S
Z
"}
(4,1,1) = {"
S
S
G
G
G
j
e
e
l
e
e
l
e
e
l
e
e
G
S
Z
"}
(5,1,1) = {"
S
G
G
G
G
G
g
g
g
g
g
g
g
g
g
g
r
G
Z
Z
"}
(6,1,1) = {"
S
G
G
G
G
G
O
g
g
g
d
g
g
g
g
g
g
y
Z
Z
"}
(7,1,1) = {"
S
G
G
G
G
G
g
g
g
g
g
g
g
g
g
g
r
G
S
Z
"}
(8,1,1) = {"
S
S
G
G
G
k
f
f
m
f
f
m
f
f
m
f
f
G
S
Z
"}
(9,1,1) = {"
b
S
S
G
G
G
G
G
G
G
G
G
G
G
G
G
G
G
S
Z
"}
(10,1,1) = {"
b
b
S
S
S
S
S
S
S
S
S
S
S
S
S
S
S
S
S
Z
"}
