//MAP CONVERTED BY dmm2tgm.py THIS HEADER COMMENT PREVENTS RECONVERSION, DO NOT REMOVE
"a" = (
/turf/simulated/mineral/random/high_chance/volcanic,
/area/ruin/unpowered)
"b" = (
/obj/effect/turf_decal/sand/plating,
/obj/structure/spider/terrorweb/queen/builder,
/obj/item/reagent_containers/food/snacks/monstermeat/spidereggs,
/turf/simulated/floor/plating/asteroid/basalt/lava_land_surface,
/area/ruin/unpowered)
"c" = (
/obj/effect/turf_decal/sand/plating,
/obj/structure/spider/terrorweb/queen/builder,
/obj/effect/mob_spawn/human/miner/explorer,
/turf/simulated/floor/plating/asteroid/basalt/lava_land_surface,
/area/ruin/unpowered)
"d" = (
/turf/simulated/floor/plating/asteroid/basalt/lava_land_surface,
/area/ruin/unpowered)
"e" = (
/obj/structure/spider/terrorweb/queen/builder,
/obj/item/reagent_containers/food/snacks/monstermeat/spidereggs,
/turf/simulated/floor/plating/asteroid/basalt/lava_land_surface,
/area/ruin/unpowered)
"f" = (
/turf/simulated/floor/plating/asteroid/basalt/lava_land_surface,
/area/lavaland/surface/outdoors)
"g" = (
/obj/effect/turf_decal/sand/plating,
/obj/structure/spider/terrorweb/queen/builder,
/obj/item/pickaxe/drill/diamonddrill,
/obj/effect/mob_spawn/human/corpse/damaged,
/turf/simulated/floor/plating/asteroid/basalt/lava_land_surface,
/area/ruin/unpowered)
"h" = (
/obj/effect/turf_decal/sand/plating,
/obj/effect/turf_decal/sand/plating,
/turf/simulated/floor/plating/asteroid/basalt/lava_land_surface,
/area/ruin/unpowered)
"i" = (
/obj/effect/mob_spawn/human/miner/explorer,
/obj/item/twohanded/fireaxe/boneaxe,
/obj/item/clothing/suit/armor/bone,
/turf/simulated/floor/plating/asteroid/basalt/lava_land_surface,
/area/ruin/unpowered)
"j" = (
/turf/simulated/floor/lava/lava_land_surface,
/area/lavaland/surface/outdoors)
"k" = (
/obj/item/kitchen/knife/combat/survival/bone,
/turf/simulated/floor/plating/asteroid/basalt/lava_land_surface,
/area/ruin/unpowered)
"l" = (
/obj/structure/spider/terrorweb/queen/builder,
/obj/structure/spider/cocoon,
/obj/effect/spawner/lootdrop/marrow_weaver,
/turf/simulated/floor/plating/asteroid/basalt/lava_land_surface,
/area/ruin/unpowered)
"m" = (
/turf/simulated/mineral/random/volcanic/hard,
/area/ruin/unpowered)
"n" = (
/obj/effect/turf_decal/sand/plating,
/obj/effect/spawner/lootdrop/marrow_weaver,
/turf/simulated/floor/plating/asteroid/basalt/lava_land_surface,
/area/ruin/unpowered)
"o" = (
/obj/effect/turf_decal/sand/plating,
/obj/structure/spider/terrorweb/queen/builder,
/obj/effect/mob_spawn/human/mime/corpse,
/turf/simulated/floor/plating/asteroid/basalt/lava_land_surface,
/area/ruin/unpowered)
"p" = (
/obj/structure/spider/terrorweb/queen/builder,
/obj/item/storage/firstaid/regular,
/turf/simulated/floor/plating/asteroid/basalt/lava_land_surface,
/area/ruin/unpowered)
"q" = (
/obj/effect/turf_decal/sand/plating,
/obj/structure/table,
/obj/item/twohanded/spear/bonespear,
/turf/simulated/floor/plating/asteroid/basalt/lava_land_surface,
/area/ruin/unpowered)
"r" = (
/obj/item/storage/firstaid/toxin,
/turf/simulated/floor/plating/asteroid/basalt/lava_land_surface,
/area/ruin/unpowered)
"s" = (
/turf/simulated/wall/mineral/sandstone,
/area/ruin/unpowered)
"t" = (
/obj/effect/spawner/lootdrop/marrow_weaver,
/turf/simulated/floor/plating/asteroid/basalt/lava_land_surface,
/area/ruin/unpowered)
"u" = (
/obj/effect/turf_decal/sand/plating,
/obj/structure/spider/terrorweb/queen/builder,
/obj/effect/mob_spawn/human/doctor,
/obj/item/gun/projectile/shotgun/boltaction,
/turf/simulated/floor/plating/asteroid/basalt/lava_land_surface,
/area/ruin/unpowered)
"v" = (
/obj/structure/spider/terrorweb/queen/builder,
/obj/effect/mob_spawn/human/miner/explorer,
/turf/simulated/floor/plating/asteroid/basalt/lava_land_surface,
/area/ruin/unpowered)
"w" = (
/obj/structure/spider/terrorweb/queen/builder,
/obj/item/gun/energy/kinetic_accelerator,
/obj/item/borg/upgrade/modkit/trigger_guard,
/turf/simulated/floor/plating/asteroid/basalt/lava_land_surface,
/area/ruin/unpowered)
"x" = (
/obj/effect/turf_decal/sand/plating,
/obj/structure/spider/terrorweb/queen/builder,
/obj/effect/mob_spawn/human/doctor,
/turf/simulated/floor/plating/asteroid/basalt/lava_land_surface,
/area/ruin/unpowered)
"y" = (
/obj/effect/turf_decal/sand/plating,
/obj/structure/spider/terrorweb/queen/builder,
/obj/item/kitchen/knife/combat,
/turf/simulated/floor/plating/asteroid/basalt/lava_land_surface,
/area/ruin/unpowered)
"z" = (
/obj/effect/spawner/lootdrop/marrow_weaver,
/obj/effect/mob_spawn/human/miner/explorer,
/turf/simulated/floor/plating/asteroid/basalt/lava_land_surface,
/area/ruin/unpowered)
"A" = (
/obj/effect/baseturf_helper/lava_land/surface,
/turf/simulated/mineral/random/volcanic/hard,
/area/ruin/unpowered)
"B" = (
/obj/effect/turf_decal/sand/plating,
/obj/structure/spider/terrorweb/queen/builder,
/obj/structure/spider/cocoon,
/obj/effect/mob_spawn/human/corpse/spacebattle/security,
/turf/simulated/floor/plating/asteroid/basalt/lava_land_surface,
/area/ruin/unpowered)
"C" = (
/obj/effect/turf_decal/sand/plating,
/obj/structure/spider/terrorweb/queen/builder,
/obj/structure/spider/cocoon,
/turf/simulated/floor/plating/asteroid/basalt/lava_land_surface,
/area/ruin/unpowered)
"D" = (
/obj/effect/turf_decal/sand/plating,
/obj/structure/bed,
/obj/effect/mob_spawn/human/miner/explorer,
/turf/simulated/floor/plating/asteroid/basalt/lava_land_surface,
/area/ruin/unpowered)
"E" = (
/obj/effect/turf_decal/sand/plating,
/obj/effect/mob_spawn/human/corpse/spacebattle/security,
/obj/item/gun/projectile/revolver/doublebarrel,
/obj/item/melee/baton,
/turf/simulated/floor/plating/asteroid/basalt/lava_land_surface,
/area/ruin/unpowered)
"F" = (
/obj/effect/turf_decal/sand/plating,
/obj/structure/spider/terrorweb/queen/builder,
/turf/simulated/floor/plating/asteroid/basalt/lava_land_surface,
/area/ruin/unpowered)
"H" = (
/obj/effect/turf_decal/sand/plating,
/obj/structure/spider/terrorweb/queen/builder,
/obj/item/tank/internals/emergency_oxygen/double,
/turf/simulated/floor/plating/asteroid/basalt/lava_land_surface,
/area/ruin/unpowered)
"I" = (
/obj/structure/spider/terrorweb/queen/builder,
/obj/structure/spider/cocoon,
/turf/simulated/floor/plating/asteroid/basalt/lava_land_surface,
/area/ruin/unpowered)
"J" = (
/obj/effect/turf_decal/sand/plating,
/obj/effect/spawner/lootdrop/marrow_weaver,
/obj/structure/spider/terrorweb/queen/builder,
/obj/effect/mob_spawn/human/mime/corpse,
/turf/simulated/floor/plating/asteroid/basalt/lava_land_surface,
/area/ruin/unpowered)
"K" = (
/obj/structure/spider/terrorweb/queen/builder,
/obj/structure/spider/terrorweb/queen/builder,
/obj/structure/spider/terrorweb/queen/builder,
/turf/simulated/floor/plating/asteroid/basalt/lava_land_surface,
/area/ruin/unpowered)
"L" = (
/obj/effect/turf_decal/sand/plating,
/obj/structure/spider/terrorweb/queen/builder,
/obj/structure/spider/cocoon,
/obj/effect/mob_spawn/human/corpse/damaged,
/turf/simulated/floor/plating/asteroid/basalt/lava_land_surface,
/area/ruin/unpowered)
"M" = (
/obj/effect/turf_decal/sand/plating,
/obj/structure/table,
/obj/item/stack/sheet/animalhide/weaver_chitin,
/turf/simulated/floor/plating/asteroid/basalt/lava_land_surface,
/area/ruin/unpowered)
"O" = (
/obj/structure/spider/terrorweb/queen/builder,
/turf/simulated/floor/plating/asteroid/basalt/lava_land_surface,
/area/ruin/unpowered)
"P" = (
/obj/effect/mapping_helpers/no_lava,
/turf/simulated/floor/plating/asteroid/basalt/lava_land_surface,
/area/lavaland/surface/outdoors)
"Q" = (
/turf/simulated/mineral/random/high_chance/volcanic,
/area/lavaland/surface/outdoors)
"R" = (
/obj/structure/spider/terrorweb/queen/builder,
/obj/item/storage/firstaid/toxin,
/turf/simulated/floor/plating/asteroid/basalt/lava_land_surface,
/area/ruin/unpowered)
"S" = (
/obj/effect/turf_decal/sand/plating,
/obj/item/flashlight/flare/torch,
/turf/simulated/floor/plating/asteroid/basalt/lava_land_surface,
/area/ruin/unpowered)
"T" = (
/turf/template_noop,
/area/template_noop)
"U" = (
/obj/effect/spawner/lootdrop/marrow_weaver,
/obj/structure/spider/terrorweb/queen/builder,
/turf/simulated/floor/plating/asteroid/basalt/lava_land_surface,
/area/ruin/unpowered)
"V" = (
/obj/structure/spider/terrorweb/queen/builder,
/obj/effect/spawner/lootdrop/marrow_weaver,
/turf/simulated/floor/plating/asteroid/basalt/lava_land_surface,
/area/ruin/unpowered)
"W" = (
/obj/effect/turf_decal/sand/plating,
/obj/effect/spawner/lootdrop/marrow_weaver,
/obj/structure/spider/terrorweb/queen/builder,
/turf/simulated/floor/plating/asteroid/basalt/lava_land_surface,
/area/ruin/unpowered)
"X" = (
/obj/structure/spider/terrorweb/queen/builder,
/obj/structure/spider/terrorweb/queen/builder,
/turf/simulated/floor/plating/asteroid/basalt/lava_land_surface,
/area/ruin/unpowered)
"Y" = (
/obj/effect/turf_decal/sand/plating,
/turf/simulated/floor/plating/asteroid/basalt/lava_land_surface,
/area/ruin/unpowered)
"Z" = (
/obj/effect/turf_decal/sand/plating,
/obj/structure/spider/terrorweb/queen/builder,
/obj/effect/spawner/lootdrop/marrow_weaver,
/turf/simulated/floor/plating/asteroid/basalt/lava_land_surface,
/area/ruin/unpowered)

(1,1,1) = {"
T
T
T
T
T
T
T
T
T
T
T
T
T
T
j
T
j
T
T
T
T
T
T
T
T
T
T
T
T
T
T
T
T
T
T
"}
(2,1,1) = {"
T
T
T
T
T
T
T
T
T
T
f
T
T
j
j
j
j
j
T
T
T
T
T
j
T
T
T
j
T
T
j
j
T
T
T
"}
(3,1,1) = {"
T
T
T
T
T
j
j
T
j
j
f
j
j
j
j
j
j
j
a
O
a
T
j
j
j
T
j
j
T
j
j
j
j
T
T
"}
(4,1,1) = {"
T
T
T
j
j
j
j
j
j
j
j
j
j
Q
f
f
j
a
a
O
a
a
j
j
j
j
j
j
j
j
Q
j
j
j
T
"}
(5,1,1) = {"
T
T
j
j
Q
f
j
j
a
a
j
a
j
j
j
j
f
a
a
U
a
a
a
a
j
j
j
f
j
j
Q
f
j
j
T
"}
(6,1,1) = {"
T
T
T
j
j
j
a
a
a
a
a
a
a
a
j
a
a
a
a
O
O
a
a
a
a
a
j
f
a
j
j
j
j
T
T
"}
(7,1,1) = {"
T
T
j
j
j
a
a
s
s
s
s
s
s
a
a
a
a
a
W
d
O
W
Y
a
a
a
a
a
a
a
j
j
Q
T
T
"}
(8,1,1) = {"
T
T
j
j
j
a
s
B
J
s
o
x
s
m
m
U
a
O
O
i
m
m
d
O
a
a
a
s
s
a
a
j
j
T
T
"}
(9,1,1) = {"
T
j
j
j
a
a
s
F
F
C
W
y
u
s
m
d
d
d
m
m
m
m
m
O
a
s
q
M
s
a
a
j
j
T
T
"}
(10,1,1) = {"
T
T
j
j
a
a
s
n
Y
Y
Y
C
s
m
m
m
F
m
m
m
m
d
O
F
a
s
Y
Y
s
a
a
j
j
j
T
"}
(11,1,1) = {"
T
j
j
j
a
a
s
Y
n
Y
n
F
s
s
e
z
d
m
m
s
d
d
m
W
a
s
D
Y
s
a
f
f
j
j
j
"}
(12,1,1) = {"
T
j
j
j
j
a
s
Y
S
Y
C
Z
F
s
O
d
d
F
F
d
O
m
m
d
a
a
s
Y
s
a
f
j
j
j
T
"}
(13,1,1) = {"
T
j
j
j
a
a
s
a
n
Y
a
g
s
m
m
m
d
Y
H
F
O
s
d
d
O
a
U
Y
a
a
a
j
j
T
T
"}
(14,1,1) = {"
T
j
j
j
a
a
a
s
a
d
s
s
m
m
m
O
U
d
m
O
d
d
O
m
W
F
O
O
I
s
a
j
j
j
T
"}
(15,1,1) = {"
T
T
j
j
j
a
a
a
a
Y
t
m
m
m
d
d
C
m
m
m
d
z
Y
m
m
e
O
d
a
a
a
j
j
f
T
"}
(16,1,1) = {"
T
T
T
j
j
j
a
a
I
d
Y
m
s
O
O
Y
O
O
m
m
m
O
m
m
m
m
s
d
W
a
s
s
f
P
P
"}
(17,1,1) = {"
T
T
j
j
j
j
j
s
t
d
C
m
m
O
U
m
m
d
O
W
F
O
s
m
m
m
F
O
F
O
s
Y
P
P
P
"}
(18,1,1) = {"
T
j
j
j
f
j
a
a
a
O
m
m
n
d
m
m
A
O
I
m
d
O
O
O
F
m
d
d
m
F
F
P
P
P
P
"}
(19,1,1) = {"
T
T
j
Q
f
j
a
l
a
V
m
m
F
r
s
c
U
O
m
m
e
v
m
O
t
d
d
m
m
d
Y
P
P
P
T
"}
(20,1,1) = {"
T
j
j
f
j
a
a
O
V
Y
m
O
X
O
F
d
d
d
m
m
t
m
m
m
Y
O
I
m
U
O
s
P
P
P
T
"}
(21,1,1) = {"
T
j
j
j
j
a
a
d
a
F
Z
s
I
t
m
m
d
O
m
m
d
m
m
m
m
m
O
O
d
a
a
j
P
T
T
"}
(22,1,1) = {"
T
j
T
j
j
a
a
O
a
O
m
m
m
d
d
m
m
O
C
s
d
O
m
s
m
m
m
b
a
a
a
j
T
T
T
"}
(23,1,1) = {"
T
j
T
T
j
j
a
l
a
Y
Y
Y
O
F
d
d
W
F
m
d
d
K
O
W
m
m
t
F
a
a
j
j
j
T
T
"}
(24,1,1) = {"
T
T
T
j
j
a
a
s
s
V
m
m
V
s
d
p
O
m
m
m
m
O
d
d
O
d
d
a
a
j
j
j
T
T
T
"}
(25,1,1) = {"
T
T
T
j
a
s
a
t
d
F
O
O
d
d
m
I
m
m
O
t
d
Y
d
d
m
d
F
R
a
a
j
j
j
j
T
"}
(26,1,1) = {"
T
T
j
j
a
a
w
d
k
Y
F
s
d
d
m
m
m
e
X
m
s
m
O
m
m
O
s
U
O
a
a
j
j
T
T
"}
(27,1,1) = {"
T
j
j
j
a
V
h
Y
t
k
d
d
W
d
m
O
O
d
d
m
n
m
O
Y
I
U
a
E
s
a
a
j
T
T
T
"}
(28,1,1) = {"
T
j
f
j
s
a
F
d
d
d
d
d
d
Y
U
O
a
s
O
d
O
O
O
d
a
a
a
a
a
a
j
j
j
T
T
"}
(29,1,1) = {"
T
j
f
j
s
C
F
n
d
c
Z
L
s
a
a
a
a
a
F
O
m
O
s
a
a
a
a
a
a
j
j
f
j
j
T
"}
(30,1,1) = {"
T
T
f
j
a
a
C
s
a
e
s
a
a
a
a
j
a
P
P
s
m
O
j
a
a
a
j
j
j
j
Q
f
j
T
T
"}
(31,1,1) = {"
T
T
j
j
j
a
a
a
j
s
a
j
f
f
j
j
j
P
P
P
P
P
j
j
j
j
j
Q
Q
j
j
j
j
j
T
"}
(32,1,1) = {"
T
T
j
j
j
j
j
j
j
j
j
j
Q
j
j
j
j
j
P
P
P
j
j
f
j
j
j
j
j
j
T
j
j
T
T
"}
(33,1,1) = {"
T
T
j
j
j
j
j
Q
j
j
j
j
j
j
T
j
j
T
f
P
P
j
j
j
j
T
T
j
j
T
T
T
j
T
T
"}
(34,1,1) = {"
T
T
T
j
T
T
j
Q
j
T
j
j
T
T
T
T
T
T
T
P
T
T
T
T
T
T
T
T
T
T
T
T
T
T
T
"}
(35,1,1) = {"
T
T
T
T
T
T
T
T
T
T
T
T
T
T
T
T
T
T
T
P
T
T
T
T
T
T
T
T
T
T
T
T
T
T
T
"}
