//MAP CONVERTED BY dmm2tgm.py THIS HEADER COMMENT PREVENTS RECONVERSION, DO NOT REMOVE
"a" = (
/turf/template_noop,
/area/template_noop)
"d" = (
/turf/simulated/wall/cult,
/area/ruin/unpowered/misc_lavaruin)
"e" = (
/obj/effect/decal/remains/human,
/turf/simulated/floor/plating/asteroid/basalt/lava_land_surface,
/area/ruin/unpowered/misc_lavaruin)
"f" = (
/obj/structure/cult/pylon,
/turf/simulated/floor/plating/asteroid/basalt/lava_land_surface,
/area/ruin/unpowered/misc_lavaruin)
"h" = (
/obj/effect/baseturf_helper/lava_land/surface,
/turf/simulated/wall/cult,
/area/ruin/unpowered/misc_lavaruin)
"n" = (
/obj/effect/decal/remains/human,
/obj/item/clothing/shoes/cult,
/obj/item/clothing/suit/hooded/cultrobes,
/turf/simulated/floor/engine/cult{
	oxygen = 14;
	nitrogen = 23;
	temperature = 300
	},
/area/ruin/unpowered/misc_lavaruin)
"s" = (
/turf/simulated/floor/plating/asteroid/basalt/lava_land_surface,
/area/ruin/unpowered/misc_lavaruin)
"w" = (
/obj/effect/decal/remains/human,
/obj/effect/decal/cleanable/blood/old,
/turf/simulated/floor/engine/cult{
	oxygen = 14;
	nitrogen = 23;
	temperature = 300
	},
/area/ruin/unpowered/misc_lavaruin)
"y" = (
/obj/effect/decal/remains/human,
/turf/simulated/floor/engine/cult{
	oxygen = 14;
	nitrogen = 23;
	temperature = 300
	},
/area/ruin/unpowered/misc_lavaruin)
"B" = (
/turf/simulated/floor/lava/lava_land_surface,
/area/ruin/unpowered/misc_lavaruin)
"F" = (
/obj/effect/decal/remains/human,
/obj/item/clothing/shoes/cult,
/obj/item/clothing/suit/hooded/cultrobes,
/obj/effect/decal/cleanable/blood/old,
/turf/simulated/floor/engine/cult{
	oxygen = 14;
	nitrogen = 23;
	temperature = 300
	},
/area/ruin/unpowered/misc_lavaruin)
"G" = (
/obj/effect/decal/remains/human,
/obj/item/melee/cultblade,
/turf/simulated/floor/engine/cult{
	oxygen = 14;
	nitrogen = 23;
	temperature = 300
	},
/area/ruin/unpowered/misc_lavaruin)
"H" = (
/obj/effect/rune/narsie{
	color = "#ff0000";
	used = 1
	},
/obj/item/cult_shift,
/obj/effect/decal/remains/human,
/obj/item/melee/cultblade/dagger,
/obj/effect/step_trigger/sound_effect{
	happens_once = 1;
	name = "a grave mistake";
	sound = list('sound/hallucinations/i_see_you1.ogg');
	triggerer_only = 1
	},
/obj/effect/step_trigger/message{
	message = "<span class='cult italic'><b><span class='big'>You've made a grave mistake, haven't you?</span></b></span>";
	name = "ohfuck"
	},
/turf/simulated/floor/engine/cult{
	oxygen = 14;
	nitrogen = 23;
	temperature = 300
	},
/area/ruin/unpowered/misc_lavaruin)
"K" = (
/obj/effect/decal/cleanable/blood/old,
/turf/simulated/floor/engine/cult{
	oxygen = 14;
	nitrogen = 23;
	temperature = 300
	},
/area/ruin/unpowered/misc_lavaruin)
"L" = (
/turf/simulated/floor/engine/cult{
	oxygen = 14;
	nitrogen = 23;
	temperature = 300
	},
/area/ruin/unpowered/misc_lavaruin)

(1,1,1) = {"
a
a
a
a
a
a
L
B
L
a
a
a
a
a
a
"}
(2,1,1) = {"
a
d
e
B
s
B
L
L
L
B
s
B
s
d
a
"}
(3,1,1) = {"
a
e
f
s
d
B
B
K
B
B
d
e
f
s
a
"}
(4,1,1) = {"
a
B
s
B
B
B
B
L
B
B
B
B
e
B
a
"}
(5,1,1) = {"
a
s
d
B
B
L
L
L
L
L
B
B
d
s
a
"}
(6,1,1) = {"
a
B
B
B
L
L
n
d
G
L
L
B
B
B
a
"}
(7,1,1) = {"
L
L
B
B
K
w
L
L
L
n
L
B
B
L
L
"}
(8,1,1) = {"
B
L
K
L
L
d
L
H
L
d
L
L
K
L
B
"}
(9,1,1) = {"
L
L
B
B
L
G
L
L
L
y
L
B
B
L
L
"}
(10,1,1) = {"
a
B
B
B
K
L
y
h
F
L
L
B
B
B
a
"}
(11,1,1) = {"
a
s
d
B
B
L
L
L
L
L
B
B
d
s
a
"}
(12,1,1) = {"
a
B
s
B
B
B
B
L
B
B
B
B
e
B
a
"}
(13,1,1) = {"
a
e
f
s
d
B
B
K
B
B
d
e
f
s
a
"}
(14,1,1) = {"
a
d
e
B
s
B
L
L
L
B
s
B
s
d
a
"}
(15,1,1) = {"
a
a
a
a
a
a
L
B
L
a
a
a
a
a
a
"}
