"ay" = (/obj/structure/table/reinforced,/obj/machinery/recharger{pixel_x = 1; pixel_y = 3},/turf/simulated/floor/pod/dark,/area/shuttle/freegolem)
"aV" = (/obj/structure/table/reinforced,/obj/item/book/manual/research_and_development{name = "Sacred Text of the Liberator"; pixel_y = 3; pixel_x = -1},/obj/machinery/light{on = 1},/turf/simulated/floor/carpet/black,/area/shuttle/freegolem)
"bq" = (/obj/effect/decal/warning_stripes/yellow/partial{dir = 4},/turf/simulated/floor/pod,/area/shuttle/freegolem)
"bE" = (/obj/structure/extinguisher_cabinet{pixel_x = -28},/obj/structure/chair/comfy/shuttle{dir = 4},/turf/simulated/floor/carpet/black,/area/shuttle/freegolem)
"cp" = (/obj/effect/turf_decal/stripes/line,/obj/machinery/door_control{id = "golem_shuttle"; name = "shuttle lockdown"; pixel_x = -32},/turf/simulated/floor/pod,/area/shuttle/freegolem)
"cI" = (/turf/simulated/wall/mineral/titanium/survival/pod,/area/shuttle/freegolem)
"cU" = (/obj/structure/table/reinforced,/obj/item/stack/sheet/metal{amount = 50; pixel_x = 2; pixel_y = -2},/obj/item/stack/sheet/glass{amount = 50},/turf/simulated/floor/pod/dark,/area/shuttle/freegolem)
"dT" = (/obj/structure/window/shuttle/survival_pod,/obj/machinery/door/poddoor/preopen{id_tag = "bridge_lockdown"; name = "Bridge Lockdown"},/obj/docking_port/stationary{area_type = /area/ruin/powered/golem_ship; dir = 8; dwidth = 8; height = 20; id = "freegolem_lavaland"; name = "Lavaland Surface"; turf_type = /turf/simulated/floor/plating/asteroid/basalt/lava_land_surface; width = 16},/obj/docking_port/mobile{dir = 8; dwidth = 8; height = 20; id = "freegolem"; name = "Free Golem Ship"; width = 16},/turf/simulated/floor/pod/dark,/area/shuttle/freegolem)
"dX" = (/obj/effect/decal/warning_stripes/yellow/partial,/turf/simulated/floor/pod,/area/shuttle/freegolem)
"eG" = (/obj/effect/decal/warning_stripes/yellow/partial{dir = 1},/obj/effect/decal/warning_stripes/yellow/partial{dir = 8},/turf/simulated/floor/pod,/area/shuttle/freegolem)
"eU" = (/turf/simulated/floor/carpet/black,/area/shuttle/freegolem)
"fk" = (/obj/effect/decal/warning_stripes/yellow/partial{dir = 8},/turf/simulated/floor/pod,/area/shuttle/freegolem)
"fo" = (/obj/machinery/light{dir = 1; layer = 1; on = 1},/turf/simulated/floor/pod/dark,/area/shuttle/freegolem)
"fu" = (/obj/effect/mapping_helpers/no_lava,/turf/simulated/floor/plating/asteroid/basalt/lava_land_surface,/area/lavaland/surface/outdoors)
"fw" = (/obj/effect/decal/warning_stripes/green/hollow,/obj/machinery/vending/snack/free,/turf/simulated/floor/pod/dark,/area/shuttle/freegolem)
"gr" = (/obj/machinery/door/airlock/survival_pod/glass,/turf/simulated/floor/pod/dark,/area/shuttle/freegolem)
"gt" = (/obj/structure/table/reinforced,/obj/item/storage/firstaid/machine,/obj/item/storage/firstaid/machine,/obj/item/storage/firstaid/machine,/obj/item/stack/nanopaste,/obj/item/stack/nanopaste,/obj/item/stack/nanopaste,/turf/simulated/floor/pod/dark,/area/shuttle/freegolem)
"iq" = (/obj/effect/decal/warning_stripes/yellow/partial,/turf/simulated/floor/pod/dark,/area/shuttle/freegolem)
"ir" = (/obj/machinery/door/airlock/survival_pod/glass,/obj/structure/fans/tiny,/obj/effect/turf_decal/box,/obj/machinery/door/poddoor/preopen{id_tag = "golem_shuttle"; name = "Entrance Lockdown"},/turf/simulated/floor/pod,/area/shuttle/freegolem)
"iu" = (/obj/machinery/door/airlock/survival_pod/glass,/turf/simulated/wall/mineral/titanium/survival/pod,/area/shuttle/freegolem)
"jd" = (/obj/effect/turf_decal/stripes/line,/turf/simulated/floor/pod,/area/shuttle/freegolem)
"jT" = (/obj/structure/table/reinforced,/obj/item/bedsheet/rd/royal_cape,/obj/item/bedsheet/rd/royal_cape{layer = 3; pixel_x = 5; pixel_y = 9},/obj/item/bedsheet/rd/royal_cape{layer = 3; pixel_x = 5; pixel_y = 9},/obj/item/bedsheet/rd/royal_cape,/obj/item/clothing/head/crown,/obj/item/clothing/head/crown,/obj/item/clothing/head/beret/sci,/obj/item/clothing/head/beret/sci,/turf/simulated/floor/pod/dark,/area/shuttle/freegolem)
"kh" = (/obj/effect/mapping_helpers/no_lava,/obj/machinery/computer/shuttle/golem_ship/recall,/turf/simulated/floor/plating/asteroid/basalt/lava_land_surface,/area/lavaland/surface/outdoors)
"kj" = (/obj/machinery/light{dir = 1; layer = 1; on = 1},/obj/structure/table/reinforced,/obj/item/mining_voucher{pixel_x = 7},/obj/item/resonator/upgraded{pixel_x = -7},/turf/simulated/floor/carpet/black,/area/shuttle/freegolem)
"kv" = (/obj/machinery/door/airlock/survival_pod,/turf/simulated/floor/pod,/area/shuttle/freegolem)
"kO" = (/obj/structure/window/shuttle/survival_pod,/obj/machinery/door_control{id = "bridge_lockdown"; name = "bridge lockdown"; pixel_x = -32},/obj/machinery/door/poddoor/preopen{id_tag = "bridge_lockdown"; name = "Bridge Lockdown"},/turf/simulated/floor/pod/dark,/area/shuttle/freegolem)
"lh" = (/obj/structure/shuttle/engine/huge{dir = 8},/turf/simulated/floor/pod/dark,/area/shuttle/freegolem)
"lZ" = (/obj/structure/table/reinforced,/obj/item/stack/cable_coil/random,/obj/item/stack/cable_coil/random,/obj/item/storage/toolbox/mechanical,/turf/simulated/floor/pod/dark,/area/shuttle/freegolem)
"me" = (/obj/structure/closet/crate/golemgear,/turf/simulated/floor/pod/dark,/area/shuttle/freegolem)
"mi" = (/obj/effect/turf_decal/box/corners,/obj/structure/rack,/obj/item/resonator,/turf/simulated/floor/pod/dark,/area/shuttle/freegolem)
"mn" = (/obj/structure/window/reinforced/survival_pod{dir = 8},/obj/effect/decal/warning_stripes/yellow/partial{dir = 4},/turf/simulated/floor/pod/dark,/area/shuttle/freegolem)
"mt" = (/obj/structure/table/reinforced,/obj/item/storage/firstaid/doctor,/obj/item/storage/firstaid/doctor,/obj/item/storage/firstaid/doctor,/obj/machinery/light{on = 1},/turf/simulated/floor/pod/dark,/area/shuttle/freegolem)
"mz" = (/obj/machinery/door/airlock/survival_pod,/obj/structure/fans/tiny,/obj/effect/turf_decal/box,/obj/machinery/door/poddoor/preopen{id_tag = "golem_shuttle"; name = "Entrance Lockdown"},/turf/simulated/floor/pod,/area/shuttle/freegolem)
"mC" = (/obj/effect/turf_decal/stripes/line{dir = 1; do_not_delete_me = 1},/turf/simulated/floor/pod,/area/shuttle/freegolem)
"mN" = (/obj/structure/chair/comfy/shuttle{dir = 4},/obj/effect/turf_decal/bot_white,/turf/simulated/floor/pod/dark,/area/shuttle/freegolem)
"mZ" = (/obj/effect/decal/warning_stripes/green/partial{dir = 4},/obj/structure/window/reinforced/survival_pod{dir = 8},/turf/simulated/floor/pod/dark,/area/shuttle/freegolem)
"nl" = (/obj/machinery/light{dir = 4; switchcount = 50},/obj/effect/turf_decal/stripes/line,/turf/simulated/floor/pod,/area/shuttle/freegolem)
"nx" = (/obj/structure/sign/mining,/turf/simulated/wall/mineral/titanium/survival/pod,/area/shuttle/freegolem)
"nZ" = (/obj/machinery/computer{desc = "A computer long since rendered non-functional due to lack of maintenance. Spitting out error messages."; dir = 1; name = "Broken Computer"},/turf/simulated/floor/pod/dark,/area/shuttle/freegolem)
"ot" = (/obj/structure/window/reinforced/survival_pod{dir = 1},/obj/effect/decal/warning_stripes/yellow/partial,/obj/effect/decal/warning_stripes/yellow/partial{dir = 4},/obj/structure/window/reinforced/survival_pod{dir = 8},/turf/simulated/floor/pod/dark,/area/shuttle/freegolem)
"oD" = (/obj/structure/shuttle/engine/heater{icon_state = "heater3x3"; tag = "icon-heater (NORTH)"; dir = 8},/obj/structure/window/reinforced/survival_pod{dir = 4},/turf/simulated/floor/pod/dark,/area/shuttle/freegolem)
"oS" = (/obj/machinery/door/airlock/survival_pod,/obj/machinery/door_control{id = "bridge_lockdown"; name = "bridge lockdown"; pixel_x = -32},/turf/simulated/floor/pod/dark,/area/shuttle/freegolem)
"oY" = (/obj/structure/computerframe,/turf/simulated/floor/pod/dark,/area/shuttle/freegolem)
"pz" = (/obj/effect/turf_decal/box,/turf/simulated/floor/pod/dark,/area/shuttle/freegolem)
"pJ" = (/obj/machinery/door/window/survival_pod{dir = 8},/turf/simulated/floor/pod/dark,/area/shuttle/freegolem)
"qf" = (/obj/effect/turf_decal/number/number_1{dir = 1},/obj/effect/mob_spawn/human/golem/adamantine,/obj/effect/turf_decal/box/white,/turf/simulated/floor/carpet/black,/area/shuttle/freegolem)
"qD" = (/obj/machinery/portable_atmospherics/canister/oxygen,/turf/simulated/floor/pod/dark,/area/shuttle/freegolem)
"rq" = (/obj/structure/table/reinforced,/obj/item/reagent_containers/spray/cleaner,/obj/item/reagent_containers/spray/cleaner{pixel_x = 5},/obj/item/reagent_containers/spray/cleaner{pixel_x = -5},/turf/simulated/floor/pod/dark,/area/shuttle/freegolem)
"rt" = (/turf/template_noop,/area/shuttle/freegolem)
"sa" = (/obj/machinery/constructable_frame/machine_frame,/turf/simulated/floor/pod,/area/shuttle/freegolem)
"ta" = (/obj/structure/reagent_dispensers/watertank/high,/obj/item/reagent_containers/glass/bucket,/turf/simulated/floor/pod/dark,/area/shuttle/freegolem)
"tc" = (/obj/machinery/computer/mech_bay_power_console,/turf/simulated/floor/pod/dark,/area/shuttle/freegolem)
"tu" = (/obj/machinery/door_control{id = "bridge_lockdown"; name = "bridge lockdown"; pixel_x = -32},/turf/simulated/wall/mineral/titanium/survival/pod,/area/shuttle/freegolem)
"tF" = (/obj/machinery/hydroponics/constructable,/obj/effect/decal/warning_stripes/green/hollow,/turf/simulated/floor/pod/dark,/area/shuttle/freegolem)
"ub" = (/obj/machinery/door/airlock/survival_pod/glass,/turf/simulated/floor/pod,/area/shuttle/freegolem)
"uO" = (/turf/simulated/floor/pod,/area/shuttle/freegolem)
"uQ" = (/obj/structure/window/reinforced/survival_pod,/obj/effect/decal/warning_stripes/green/partial{dir = 1},/turf/simulated/floor/pod/dark,/area/shuttle/freegolem)
"vO" = (/obj/structure/reagent_dispensers/watertank/high,/turf/simulated/floor/pod/dark,/area/shuttle/freegolem)
"wo" = (/obj/effect/decal/warning_stripes/yellow/partial{dir = 4},/turf/simulated/floor/pod/dark,/area/shuttle/freegolem)
"wG" = (/obj/structure/sign/mining/survival,/turf/simulated/wall/mineral/titanium/survival/pod,/area/shuttle/freegolem)
"xv" = (/obj/structure/window/reinforced/survival_pod{density = 0; dir = 6},/turf/simulated/floor/pod/dark,/area/shuttle/freegolem)
"xI" = (/obj/machinery/door_control{id = "bridge_lockdown"; name = "bridge lockdown"; pixel_x = -32},/obj/structure/window/shuttle/survival_pod,/obj/machinery/door/poddoor/preopen{id_tag = "bridge_lockdown"; name = "Bridge Lockdown"},/turf/simulated/floor/pod/dark,/area/shuttle/freegolem)
"yf" = (/turf/simulated/floor/pod/dark,/area/shuttle/freegolem)
"yh" = (/obj/effect/decal/warning_stripes/green/partial{dir = 4},/obj/machinery/vending/hydroseeds,/obj/effect/decal/warning_stripes/green/partial{dir = 6},/obj/effect/decal/warning_stripes/green/partial{dir = 1},/turf/simulated/floor/pod/dark,/area/shuttle/freegolem)
"yw" = (/obj/structure/window/reinforced/survival_pod{dir = 10; density = 0},/turf/simulated/floor/pod/dark,/area/shuttle/freegolem)
"yB" = (/turf/template_noop,/area/template_noop)
"yO" = (/turf/simulated/floor/mech_bay_recharge_floor{icon_state = "recharge_floor_dark"},/area/shuttle/freegolem)
"zc" = (/obj/structure/sign/mining/survival{tag = "icon-survival (NORTH)"; icon_state = "survival"; dir = 1},/turf/simulated/wall/mineral/titanium/survival/pod,/area/shuttle/freegolem)
"Ag" = (/obj/structure/reagent_dispensers/fueltank,/turf/simulated/floor/pod/dark,/area/shuttle/freegolem)
"AL" = (/obj/machinery/light{dir = 4; switchcount = 50},/obj/structure/table/reinforced,/obj/item/reagent_containers/spray/plantbgone{pixel_x = 5; pixel_y = 6},/obj/item/reagent_containers/spray/plantbgone{pixel_x = -5; pixel_y = 6},/obj/item/reagent_containers/spray/plantbgone{pixel_y = 3},/turf/simulated/floor/pod/dark,/area/shuttle/freegolem)
"BF" = (/obj/machinery/mineral/ore_redemption/golem,/obj/machinery/light{dir = 4; pixel_y = -32},/turf/simulated/floor/pod/dark,/area/shuttle/freegolem)
"BG" = (/obj/effect/turf_decal/loading_area,/obj/effect/turf_decal/box/corners,/obj/effect/turf_decal/box/corners{dir = 8},/obj/structure/ore_box,/turf/simulated/floor/pod/dark,/area/shuttle/freegolem)
"BI" = (/obj/machinery/light{dir = 4; switchcount = 50},/obj/structure/closet/crate/hydroponics/prespawned,/turf/simulated/floor/pod/dark,/area/shuttle/freegolem)
"BN" = (/obj/structure/chair/comfy/shuttle{dir = 8},/obj/machinery/door_control{id = "golem_shuttle"; name = "shuttle lockdown"; pixel_x = -32},/turf/simulated/floor/carpet/black,/area/shuttle/freegolem)
"Ch" = (/obj/machinery/door_control{id = "golem_shuttle"; name = "shuttle lockdown"; pixel_x = -32},/turf/simulated/wall/mineral/titanium/survival/pod,/area/shuttle/freegolem)
"Cl" = (/obj/machinery/hydroponics/constructable,/obj/machinery/light{dir = 8; pixel_y = -32},/obj/effect/decal/warning_stripes/green/hollow,/turf/simulated/floor/pod/dark,/area/shuttle/freegolem)
"Ct" = (/obj/structure/shuttle/engine/heater{icon_state = "heater3x3_side"; tag = "icon-heater (NORTH)"; dir = 8},/obj/structure/window/reinforced/survival_pod{dir = 4},/turf/simulated/floor/pod/dark,/area/shuttle/freegolem)
"CQ" = (/obj/machinery/vending/wallmed{pixel_x = -25},/obj/structure/chair/comfy/shuttle{dir = 4},/turf/simulated/floor/carpet/black,/area/shuttle/freegolem)
"DN" = (/obj/machinery/mineral/equipment_vendor/golem,/turf/simulated/floor/pod/dark,/area/shuttle/freegolem)
"DS" = (/obj/structure/ore_box,/obj/effect/turf_decal/delivery,/turf/simulated/floor/pod/dark,/area/shuttle/freegolem)
"Ev" = (/obj/structure/window/reinforced/survival_pod{dir = 9; density = 0},/obj/effect/decal/warning_stripes/yellow/partial{dir = 4},/turf/simulated/floor/pod/dark,/area/shuttle/freegolem)
"Ez" = (/obj/machinery/door_control{id = "golem_shuttle"; name = "shuttle lockdown"; pixel_x = -32},/obj/effect/decal/warning_stripes/yellow/partial{dir = 4},/obj/effect/decal/warning_stripes/yellow/partial{dir = 1},/turf/simulated/floor/pod,/area/shuttle/freegolem)
"EF" = (/obj/effect/turf_decal/box/corners{dir = 8},/obj/structure/rack,/obj/item/resonator,/turf/simulated/floor/pod/dark,/area/shuttle/freegolem)
"Fq" = (/obj/structure/table/reinforced,/obj/item/storage/firstaid/adv,/obj/item/storage/firstaid/adv,/obj/item/storage/firstaid/adv,/turf/simulated/floor/pod/dark,/area/shuttle/freegolem)
"Ft" = (/obj/effect/turf_decal/box/corners{dir = 1},/obj/structure/rack,/obj/item/resonator,/turf/simulated/wall/mineral/titanium/survival/pod,/area/shuttle/freegolem)
"FH" = (/obj/structure/chair/comfy/shuttle{dir = 8},/turf/simulated/floor/carpet/black,/area/shuttle/freegolem)
"Gu" = (/obj/effect/turf_decal/number/number_4{dir = 1},/obj/effect/mob_spawn/human/golem/adamantine,/obj/effect/turf_decal/box/white,/obj/machinery/door_control{id = "golem_shuttle"; name = "shuttle lockdown"; pixel_x = -32},/turf/simulated/floor/carpet/black,/area/shuttle/freegolem)
"GE" = (/obj/machinery/door/airlock/survival_pod,/turf/simulated/floor/pod/dark,/area/shuttle/freegolem)
"KY" = (/obj/machinery/light{dir = 8; pixel_y = -32},/obj/effect/decal/warning_stripes/yellow/partial{dir = 4},/turf/simulated/floor/pod,/area/shuttle/freegolem)
"Lv" = (/obj/structure/statue/gold/rd{name = "statue of the Liberator"},/turf/simulated/floor/pod/dark,/area/shuttle/freegolem)
"LL" = (/obj/structure/shuttle/engine/heater{icon_state = "heater3x3_side_inv"; tag = "icon-heater (NORTH)"; dir = 8},/obj/structure/window/reinforced/survival_pod{dir = 4},/turf/simulated/floor/pod/dark,/area/shuttle/freegolem)
"LV" = (/obj/machinery/vending/hydronutrients,/obj/effect/decal/warning_stripes/green/partial{dir = 8},/obj/effect/decal/warning_stripes/green/partial{dir = 6},/obj/effect/decal/warning_stripes/green/partial{dir = 1},/turf/simulated/floor/pod/dark,/area/shuttle/freegolem)
"Md" = (/obj/structure/table/reinforced,/obj/item/disk/design_disk/golem_shell,/obj/item/areaeditor/golem,/turf/simulated/floor/pod/dark,/area/shuttle/freegolem)
"MI" = (/obj/machinery/mech_bay_recharge_port{dir = 8},/turf/simulated/floor/pod/dark,/area/shuttle/freegolem)
"MJ" = (/obj/machinery/light{dir = 8; pixel_y = -32},/obj/machinery/door_control{id = "golem_shuttle"; name = "shuttle lockdown"; pixel_x = -32},/obj/effect/decal/warning_stripes/yellow/partial{dir = 4},/obj/effect/decal/warning_stripes/yellow/partial,/turf/simulated/floor/pod,/area/shuttle/freegolem)
"MW" = (/obj/machinery/light{dir = 4; switchcount = 50},/obj/effect/turf_decal/stripes/line{dir = 1; do_not_delete_me = 1},/turf/simulated/floor/pod,/area/shuttle/freegolem)
"Nx" = (/obj/structure/closet/crate/golemgear,/obj/machinery/light{dir = 1; layer = 1; on = 1},/turf/simulated/floor/pod/dark,/area/shuttle/freegolem)
"NV" = (/obj/structure/table/reinforced,/turf/simulated/floor/carpet/black,/area/shuttle/freegolem)
"Oc" = (/obj/effect/turf_decal/number/number_2{dir = 1},/obj/effect/mob_spawn/human/golem/adamantine,/obj/effect/turf_decal/box/white,/turf/simulated/floor/carpet/black,/area/shuttle/freegolem)
"OK" = (/obj/structure/closet/crate/engineering,/obj/item/storage/toolbox/mechanical,/obj/item/storage/toolbox/mechanical,/obj/item/storage/toolbox/mechanical,/obj/item/storage/toolbox/electrical,/obj/item/storage/toolbox/electrical,/obj/item/clothing/head/welding,/obj/item/clothing/head/welding,/obj/item/multitool/abductor,/turf/simulated/floor/pod/dark,/area/shuttle/freegolem)
"Pn" = (/obj/structure/table/reinforced,/obj/item/clothing/glasses/hud/hydroponic,/obj/item/clothing/glasses/hud/hydroponic,/obj/item/clothing/glasses/hud/hydroponic,/turf/simulated/floor/pod/dark,/area/shuttle/freegolem)
"Ps" = (/obj/machinery/light{dir = 8; pixel_y = -32},/obj/effect/decal/warning_stripes/green/hollow,/obj/machinery/vending/coffee/free,/turf/simulated/floor/pod/dark,/area/shuttle/freegolem)
"PF" = (/obj/machinery/light{on = 1},/turf/simulated/floor/pod/dark,/area/shuttle/freegolem)
"PZ" = (/obj/effect/turf_decal/number/number_3{dir = 1},/obj/effect/turf_decal/number/number_3{dir = 1},/obj/effect/mob_spawn/human/golem/adamantine,/obj/effect/turf_decal/box/white,/turf/simulated/floor/carpet/black,/area/shuttle/freegolem)
"Qt" = (/obj/structure/window/reinforced/survival_pod{dir = 8},/turf/simulated/floor/pod/dark,/area/shuttle/freegolem)
"RQ" = (/obj/effect/decal/warning_stripes/yellow/partial{dir = 1},/turf/simulated/floor/pod,/area/shuttle/freegolem)
"SD" = (/obj/machinery/autolathe,/turf/simulated/floor/pod/dark,/area/shuttle/freegolem)
"SX" = (/obj/effect/turf_decal/delivery,/turf/simulated/floor/pod/dark,/area/shuttle/freegolem)
"SY" = (/obj/machinery/door_control{id = "golem_shuttle"; name = "shuttle lockdown"; pixel_x = -32},/obj/structure/lattice/catwalk,/turf/simulated/floor/pod/dark,/area/shuttle/freegolem)
"Tf" = (/obj/effect/turf_decal/box/corners{dir = 4},/obj/structure/rack,/obj/item/resonator,/turf/simulated/floor/pod/dark,/area/shuttle/freegolem)
"TQ" = (/obj/effect/decal/warning_stripes/yellow/partial,/obj/effect/decal/warning_stripes/yellow/partial{dir = 8},/turf/simulated/floor/pod,/area/shuttle/freegolem)
"Uh" = (/obj/structure/lattice/catwalk,/turf/simulated/floor/pod/dark,/area/shuttle/freegolem)
"UC" = (/obj/structure/computerframe,/obj/machinery/light{dir = 8; pixel_y = -32},/turf/simulated/floor/pod,/area/shuttle/freegolem)
"Vi" = (/obj/effect/turf_decal/stripes/line{dir = 1; do_not_delete_me = 1},/obj/machinery/door_control{id = "golem_shuttle"; name = "shuttle lockdown"; pixel_x = -32},/turf/simulated/floor/pod,/area/shuttle/freegolem)
"Wn" = (/obj/structure/window/reinforced/survival_pod{dir = 1},/obj/effect/decal/warning_stripes/yellow/partial,/turf/simulated/floor/pod/dark,/area/shuttle/freegolem)
"WX" = (/obj/machinery/door/window/survival_pod{dir = 8},/obj/effect/decal/warning_stripes/yellow/partial{dir = 4},/turf/simulated/floor/pod/dark,/area/shuttle/freegolem)
"WZ" = (/obj/machinery/computer/crew{dir = 4},/turf/simulated/floor/pod/dark,/area/shuttle/freegolem)
"Xe" = (/obj/structure/window/shuttle/survival_pod,/obj/machinery/door/poddoor/preopen{id_tag = "bridge_lockdown"; name = "Bridge Lockdown"},/turf/simulated/floor/pod/dark,/area/shuttle/freegolem)
"Xq" = (/obj/machinery/light{dir = 8; pixel_y = -32},/turf/simulated/floor/pod/dark,/area/shuttle/freegolem)
"XV" = (/obj/machinery/light{dir = 8; pixel_y = -32},/obj/structure/closet/crate/golemgear,/turf/simulated/floor/pod/dark,/area/shuttle/freegolem)
"YL" = (/obj/machinery/floodlight,/turf/simulated/floor/pod/dark,/area/shuttle/freegolem)
"ZQ" = (/obj/machinery/door_control{id = "bridge_lockdown"; name = "bridge lockdown"; pixel_x = -32},/turf/simulated/floor/pod/dark,/area/shuttle/freegolem)

(1,1,1) = {"
yByBcIzccIcIcIcIyByByByByBfufufufuyByByByByByByByByByByByByB
rtyfcICtcIPsfwcIcIcIzccIcIfufufufuyByByByByByByByByByByByByB
rtlhcIoDcIyfyfyfyfyfyfBIcIcISYUhzccIcIcIcIyByByByByByByByByB
rtyfcILLcIxvuQuQuQywyfyftacImzmzcImeNxmecIcIyByByByByByByByB
yByBcIwGcIcICltFtFmZyfyfPncIVimCcIyfcIcImecIcIyByByByByByByB
yByByByByBcIyfyfyfyfyfyfALcIjdnlcIDScIyfyfmecIzccIcIyByByByB
yByByByByBcItFtFtFyhLVyfYLcIirircIcIDSyfOKmecIkjNVkOXeXecIyB
yByByBcIcIcIcIcIcIcIcIGEnxcIMJdXTQcIcIgrcIcIcICQFHQtmNnZXecI
yByBrtyfcICtcIUCsasamnyfDNcIbquOfkcIFtyffoTftuqfOcQtyfmNWZXe
yByBrtlhcIoDcIuOuOuOyfyfyfkvKYuOfkubyfpzpzZQoSeUeUpJyfmNoYdT
yByBrtyfcILLcIsasasamnyfBGcIbquOfkcIEFyfPFmicIPZGuQtyfmNnZXe
yByByBcIcIcIcIotWnWnEvyfBFcIEzRQeGcIcIiucIcIcIbEBNQtmNnZXecI
yByByByByBcILvWXyfyfwoyfSXcIirircIcIqDyfyfAgcIaVNVxIXeXecIyB
yByByByByBcIMdWXXqyfwoyfSDcImCMWcIrqyfyfyfAgcIwGcIcIyByByByB
yByBcIzccIcIcIcIiqiqyfyfcUChcpjdcIjTyfyfvOcIcIyByByByByByByB
rtyfcICtcIXVyfGEyfyfyfyflZcImzmzcIgtmtFqcIcIyByByByByByByByB
rtlhcIoDcImeyfcItcyOMIaycIcISYUhwGcIcIcIcIyByByByByByByByByB
rtyfcILLcIDSDScIcIcIwGcIcIfufufukhyByByByByByByByByByByByByB
yByBcIwGcIcIcIcIyByByByByBfufufufuyByByByByByByByByByByByByB
"}
