//MAP CONVERTED BY dmm2tgm.py THIS HEADER COMMENT PREVENTS RECONVERSION, DO NOT REMOVE
"a" = (
/obj/effect/mapping_helpers/no_lava,
/turf/simulated/floor/plating/asteroid/basalt/lava_land_surface,
/area/lavaland/surface/outdoors/explored)
"c" = (
/obj/structure/stone_tile/block,
/obj/structure/stone_tile{
	dir = 1
	},
/turf/simulated/floor/plating/asteroid/basalt/lava_land_surface,
/area/ruin/unpowered/misc_lavaruin)
"d" = (
/obj/structure/stone_tile/block{
	dir = 1
	},
/obj/structure/stone_tile{
	dir = 8
	},
/turf/simulated/floor/plating/asteroid/basalt/lava_land_surface,
/area/ruin/unpowered/misc_lavaruin)
"f" = (
/turf/simulated/floor/plating/lava/smooth/lava_land_surface,
/area/ruin/unpowered/misc_lavaruin)
"i" = (
/obj/structure/stone_tile/block,
/obj/structure/stone_tile/block{
	dir = 1
	},
/turf/simulated/floor/plating/asteroid/basalt/lava_land_surface,
/area/ruin/unpowered/misc_lavaruin)
"j" = (
/turf/simulated/floor/plating/asteroid/basalt/lava_land_surface,
/area/ruin/unpowered/misc_lavaruin)
"k" = (
/obj/structure/stone_tile/slab,
/obj/structure/world_anvil,
/turf/simulated/floor/plating/asteroid/basalt/lava_land_surface,
/area/ruin/unpowered/misc_lavaruin)
"l" = (
/obj/structure/stone_tile/center/cracked,
/obj/structure/stone_tile/surrounding_tile,
/obj/structure/stone_tile/surrounding_tile{
	dir = 1
	},
/obj/structure/stone_tile/surrounding_tile{
	dir = 8
	},
/turf/simulated/floor/plating/asteroid/basalt/lava_land_surface,
/area/ruin/unpowered/misc_lavaruin)
"n" = (
/obj/structure/stone_tile/block,
/obj/structure/stone_tile/block/cracked{
	dir = 1
	},
/turf/simulated/floor/plating/lava/smooth/lava_land_surface,
/area/ruin/unpowered/misc_lavaruin)
"q" = (
/obj/structure/stone_tile/center/cracked,
/obj/structure/stone_tile/surrounding_tile,
/obj/structure/stone_tile/surrounding_tile{
	dir = 4
	},
/obj/structure/stone_tile/surrounding_tile{
	dir = 8
	},
/turf/simulated/floor/plating/asteroid/basalt/lava_land_surface,
/area/ruin/unpowered/misc_lavaruin)
"s" = (
/obj/structure/stone_tile/center/cracked,
/obj/structure/stone_tile/surrounding_tile,
/obj/structure/stone_tile/surrounding_tile{
	dir = 1
	},
/obj/structure/stone_tile/surrounding_tile{
	dir = 4
	},
/turf/simulated/floor/plating/asteroid/basalt/lava_land_surface,
/area/ruin/unpowered/misc_lavaruin)
"t" = (
/obj/effect/mapping_helpers/no_lava,
/obj/structure/stone_tile{
	dir = 8
	},
/turf/simulated/floor/plating/asteroid/basalt/lava_land_surface,
/area/lavaland/surface/outdoors/explored)
"u" = (
/turf/simulated/floor/plating/lava/smooth/lava_land_surface,
/area/lavaland/surface/outdoors/explored)
"x" = (
/obj/structure/stone_tile/block{
	dir = 4
	},
/turf/simulated/floor/plating/asteroid/basalt/lava_land_surface,
/area/ruin/unpowered/misc_lavaruin)
"y" = (
/obj/structure/stone_tile{
	dir = 8
	},
/turf/simulated/floor/plating/asteroid/basalt/lava_land_surface,
/area/ruin/unpowered/misc_lavaruin)
"z" = (
/obj/structure/stone_tile/block{
	dir = 4
	},
/obj/structure/stone_tile/block{
	dir = 8
	},
/turf/simulated/floor/plating/asteroid/basalt/lava_land_surface,
/area/ruin/unpowered/misc_lavaruin)
"A" = (
/obj/structure/stone_tile/block{
	dir = 4
	},
/obj/structure/stone_tile/block{
	dir = 8
	},
/turf/simulated/floor/plating/lava/smooth/lava_land_surface,
/area/ruin/unpowered/misc_lavaruin)
"B" = (
/obj/structure/stone_tile/center/cracked,
/obj/structure/stone_tile/surrounding_tile{
	dir = 1
	},
/obj/structure/stone_tile/surrounding_tile{
	dir = 4
	},
/obj/structure/stone_tile/surrounding_tile{
	dir = 8
	},
/turf/simulated/floor/plating/asteroid/basalt/lava_land_surface,
/area/ruin/unpowered/misc_lavaruin)
"D" = (
/obj/structure/stone_tile,
/turf/simulated/floor/plating/asteroid/basalt/lava_land_surface,
/area/ruin/unpowered/misc_lavaruin)
"G" = (
/obj/structure/stone_tile/block/cracked{
	dir = 8
	},
/obj/structure/stone_tile{
	dir = 1
	},
/turf/simulated/floor/plating/asteroid/basalt/lava_land_surface,
/area/ruin/unpowered/misc_lavaruin)
"H" = (
/obj/effect/mapping_helpers/no_lava,
/obj/structure/stone_tile{
	dir = 1
	},
/turf/simulated/floor/plating/asteroid/basalt/lava_land_surface,
/area/lavaland/surface/outdoors/explored)
"J" = (
/obj/effect/mapping_helpers/no_lava,
/obj/structure/stone_tile{
	dir = 4
	},
/turf/simulated/floor/plating/asteroid/basalt/lava_land_surface,
/area/lavaland/surface/outdoors/explored)
"K" = (
/turf/template_noop,
/area/template_noop)
"L" = (
/turf/simulated/wall/indestructible/boss,
/area/ruin/unpowered/misc_lavaruin)
"M" = (
/obj/structure/stone_tile{
	dir = 4
	},
/turf/simulated/floor/plating/asteroid/basalt/lava_land_surface,
/area/ruin/unpowered/misc_lavaruin)
"T" = (
/obj/structure/stone_tile{
	dir = 1
	},
/obj/structure/stone_tile{
	dir = 8
	},
/turf/simulated/floor/plating/asteroid/basalt/lava_land_surface,
/area/ruin/unpowered/misc_lavaruin)
"V" = (
/obj/structure/stone_tile/block/cracked,
/obj/structure/stone_tile/block{
	dir = 1
	},
/turf/simulated/floor/plating/lava/smooth/lava_land_surface,
/area/ruin/unpowered/misc_lavaruin)
"W" = (
/turf/space,
/area/space)
"X" = (
/obj/structure/stone_tile{
	dir = 1
	},
/turf/simulated/floor/plating/asteroid/basalt/lava_land_surface,
/area/ruin/unpowered/misc_lavaruin)
"Y" = (
/obj/structure/stone_tile/block{
	dir = 4
	},
/obj/structure/stone_tile/block/cracked{
	dir = 8
	},
/turf/simulated/floor/plating/asteroid/basalt/lava_land_surface,
/area/ruin/unpowered/misc_lavaruin)

(1,1,1) = {"
K
K
u
K
u
K
K
J
K
K
u
u
K
K
K
"}
(2,1,1) = {"
K
u
u
u
u
u
a
a
a
u
u
u
u
u
K
"}
(3,1,1) = {"
u
u
L
L
L
f
j
y
j
f
L
L
L
u
u
"}
(4,1,1) = {"
u
u
L
j
j
j
j
j
j
j
j
j
L
u
u
"}
(5,1,1) = {"
u
u
L
j
j
j
M
G
y
j
j
j
L
u
K
"}
(6,1,1) = {"
K
u
f
j
j
L
L
A
L
L
j
j
f
a
K
"}
(7,1,1) = {"
K
a
j
j
M
L
l
z
s
L
y
j
j
a
a
"}
(8,1,1) = {"
a
t
j
X
d
V
i
k
i
n
c
X
j
t
a
"}
(9,1,1) = {"
K
a
j
j
X
L
q
Y
B
L
j
j
j
a
K
"}
(10,1,1) = {"
K
u
f
j
j
L
L
A
L
L
j
j
f
u
K
"}
(11,1,1) = {"
u
u
L
j
j
j
X
x
D
j
j
j
L
u
K
"}
(12,1,1) = {"
u
u
L
j
j
j
j
T
j
j
j
j
L
u
u
"}
(13,1,1) = {"
K
K
L
L
L
f
j
j
j
f
L
L
L
u
K
"}
(14,1,1) = {"
K
u
u
u
u
u
a
H
a
a
u
u
u
u
K
"}
(15,1,1) = {"
K
K
K
u
K
K
K
a
K
K
K
u
u
K
K
"}

(1,1,2) = {"
W
W
W
W
W
W
W
W
W
W
W
W
W
W
W
"}
(2,1,2) = {"
W
W
W
W
W
W
W
W
W
W
W
W
W
W
W
"}
(3,1,2) = {"
W
W
W
W
W
W
W
W
W
W
W
W
W
W
W
"}
(4,1,2) = {"
W
W
W
W
W
W
W
W
W
W
W
W
W
W
W
"}
(5,1,2) = {"
W
W
W
W
W
W
W
W
W
W
W
W
W
W
W
"}
(6,1,2) = {"
W
W
W
W
W
W
W
W
W
W
W
W
W
W
W
"}
(7,1,2) = {"
W
W
W
W
W
W
W
W
W
W
W
W
W
W
W
"}
(8,1,2) = {"
W
W
W
W
W
W
W
W
W
W
W
W
W
W
W
"}
(9,1,2) = {"
W
W
W
W
W
W
W
W
W
W
W
W
W
W
W
"}
(10,1,2) = {"
W
W
W
W
W
W
W
W
W
W
W
W
W
W
W
"}
(11,1,2) = {"
W
W
W
W
W
W
W
W
W
W
W
W
W
W
W
"}
(12,1,2) = {"
W
W
W
W
W
W
W
W
W
W
W
W
W
W
W
"}
(13,1,2) = {"
W
W
W
W
W
W
W
W
W
W
W
W
W
W
W
"}
(14,1,2) = {"
W
W
W
W
W
W
W
W
W
W
W
W
W
W
W
"}
(15,1,2) = {"
W
W
W
W
W
W
W
W
W
W
W
W
W
W
W
"}

(1,1,3) = {"
W
W
W
W
W
W
W
W
W
W
W
W
W
W
W
"}
(2,1,3) = {"
W
W
W
W
W
W
W
W
W
W
W
W
W
W
W
"}
(3,1,3) = {"
W
W
W
W
W
W
W
W
W
W
W
W
W
W
W
"}
(4,1,3) = {"
W
W
W
W
W
W
W
W
W
W
W
W
W
W
W
"}
(5,1,3) = {"
W
W
W
W
W
W
W
W
W
W
W
W
W
W
W
"}
(6,1,3) = {"
W
W
W
W
W
W
W
W
W
W
W
W
W
W
W
"}
(7,1,3) = {"
W
W
W
W
W
W
W
W
W
W
W
W
W
W
W
"}
(8,1,3) = {"
W
W
W
W
W
W
W
W
W
W
W
W
W
W
W
"}
(9,1,3) = {"
W
W
W
W
W
W
W
W
W
W
W
W
W
W
W
"}
(10,1,3) = {"
W
W
W
W
W
W
W
W
W
W
W
W
W
W
W
"}
(11,1,3) = {"
W
W
W
W
W
W
W
W
W
W
W
W
W
W
W
"}
(12,1,3) = {"
W
W
W
W
W
W
W
W
W
W
W
W
W
W
W
"}
(13,1,3) = {"
W
W
W
W
W
W
W
W
W
W
W
W
W
W
W
"}
(14,1,3) = {"
W
W
W
W
W
W
W
W
W
W
W
W
W
W
W
"}
(15,1,3) = {"
W
W
W
W
W
W
W
W
W
W
W
W
W
W
W
"}
