//MAP CONVERTED BY dmm2tgm.py THIS HEADER COMMENT PREVENTS RECONVERSION, DO NOT REMOVE
"aa" = (
/turf/template_noop,
/area/template_noop)
"ab" = (
/obj/structure/disposalpipe/segment{
	dir = 6
	},
/turf/simulated/wall/r_wall,
/area/ruin/powered/clownplanet)
"ac" = (
/obj/structure/disposalpipe/segment{
	dir = 10
	},
/turf/simulated/wall/r_wall,
/area/ruin/powered/clownplanet)
"ad" = (
/obj/structure/disposalpipe/segment{
	dir = 6
	},
/turf/simulated/floor/plating,
/area/ruin/powered/clownplanet)
"ae" = (
/obj/structure/disposalpipe/segment{
	dir = 10
	},
/turf/simulated/floor/plating,
/area/ruin/powered/clownplanet)
"ah" = (
/obj/effect/turf_decal/tile/yellow,
/obj/effect/turf_decal/tile/yellow{
	dir = 1
	},
/obj/effect/turf_decal/tile/yellow{
	dir = 8
	},
/obj/effect/turf_decal/tile/yellow{
	dir = 4
	},
/obj/structure/disposalpipe/segment{
	dir = 6
	},
/turf/simulated/floor/lubed,
/area/ruin/powered/clownplanet)
"ai" = (
/obj/structure/disposalpipe/sortjunction{
	dir = 1
	},
/turf/simulated/wall/r_wall,
/area/ruin/powered/clownplanet)
"al" = (
/obj/effect/decal/cleanable/dirt,
/obj/effect/turf_decal/tile/yellow,
/obj/effect/turf_decal/tile/yellow{
	dir = 1
	},
/obj/effect/turf_decal/tile/yellow{
	dir = 8
	},
/obj/effect/turf_decal/tile/yellow{
	dir = 4
	},
/obj/structure/disposalpipe/segment{
	dir = 5
	},
/turf/simulated/floor/lubed,
/area/ruin/powered/clownplanet)
"ao" = (
/obj/structure/window/reinforced,
/obj/structure/disposalpipe/segment{
	dir = 9
	},
/turf/simulated/floor/plating,
/area/ruin/powered/clownplanet)
"ap" = (
/obj/effect/turf_decal/tile/yellow,
/obj/effect/turf_decal/tile/yellow{
	dir = 1
	},
/obj/effect/turf_decal/tile/yellow{
	dir = 8
	},
/obj/effect/turf_decal/tile/yellow{
	dir = 4
	},
/obj/structure/disposalpipe/segment{
	dir = 9
	},
/turf/simulated/floor/lubed,
/area/ruin/powered/clownplanet)
"aq" = (
/obj/structure/disposalpipe/trunk,
/obj/structure/disposaloutlet{
	dir = 1
	},
/turf/simulated/floor/plating,
/area/ruin/powered/clownplanet)
"ar" = (
/obj/effect/turf_decal/tile/yellow,
/obj/effect/turf_decal/tile/yellow{
	dir = 1
	},
/obj/effect/turf_decal/tile/yellow{
	dir = 8
	},
/obj/effect/turf_decal/tile/yellow{
	dir = 4
	},
/turf/simulated/floor/lubed,
/area/ruin/powered/clownplanet)
"as" = (
/obj/effect/decal/cleanable/dirt,
/obj/effect/turf_decal/tile/yellow,
/obj/effect/turf_decal/tile/yellow{
	dir = 1
	},
/obj/effect/turf_decal/tile/yellow{
	dir = 8
	},
/obj/effect/turf_decal/tile/yellow{
	dir = 4
	},
/turf/simulated/floor/lubed,
/area/ruin/powered/clownplanet)
"av" = (
/obj/effect/turf_decal/tile/yellow,
/obj/effect/turf_decal/tile/yellow{
	dir = 1
	},
/obj/effect/turf_decal/tile/yellow{
	dir = 8
	},
/obj/effect/turf_decal/tile/yellow{
	dir = 4
	},
/obj/structure/disposalpipe/segment{
	dir = 5
	},
/turf/simulated/floor/lubed,
/area/ruin/powered/clownplanet)
"aw" = (
/obj/machinery/light/small{
	dir = 1
	},
/obj/effect/turf_decal/tile/yellow,
/obj/effect/turf_decal/tile/yellow{
	dir = 1
	},
/obj/effect/turf_decal/tile/yellow{
	dir = 8
	},
/obj/effect/turf_decal/tile/yellow{
	dir = 4
	},
/turf/simulated/floor/lubed,
/area/ruin/powered/clownplanet)
"ay" = (
/obj/effect/decal/cleanable/dirt,
/obj/effect/turf_decal/tile/yellow,
/obj/effect/turf_decal/tile/yellow{
	dir = 1
	},
/obj/effect/turf_decal/tile/yellow{
	dir = 8
	},
/obj/effect/turf_decal/tile/yellow{
	dir = 4
	},
/obj/structure/disposalpipe/segment{
	dir = 9
	},
/turf/simulated/floor/lubed,
/area/ruin/powered/clownplanet)
"az" = (
/obj/item/bikehorn,
/obj/effect/turf_decal/tile/yellow,
/obj/effect/turf_decal/tile/yellow{
	dir = 1
	},
/obj/effect/turf_decal/tile/yellow{
	dir = 8
	},
/obj/effect/turf_decal/tile/yellow{
	dir = 4
	},
/obj/structure/disposalpipe/segment{
	dir = 5
	},
/turf/simulated/floor/lubed,
/area/ruin/powered/clownplanet)
"aA" = (
/obj/structure/disposalpipe/segment{
	dir = 5
	},
/turf/simulated/wall/r_wall,
/area/ruin/powered/clownplanet)
"aC" = (
/obj/effect/turf_decal/tile/yellow,
/obj/effect/turf_decal/tile/yellow{
	dir = 1
	},
/obj/effect/turf_decal/tile/yellow{
	dir = 8
	},
/obj/effect/turf_decal/tile/yellow{
	dir = 4
	},
/obj/structure/disposalpipe/segment{
	dir = 10
	},
/turf/simulated/floor/lubed,
/area/ruin/powered/clownplanet)
"aE" = (
/obj/structure/disposalpipe/segment{
	dir = 9
	},
/turf/simulated/floor/plating,
/area/ruin/powered/clownplanet)
"aG" = (
/obj/machinery/light/small{
	dir = 4
	},
/obj/effect/turf_decal/tile/yellow,
/obj/effect/turf_decal/tile/yellow{
	dir = 1
	},
/obj/effect/turf_decal/tile/yellow{
	dir = 8
	},
/obj/effect/turf_decal/tile/yellow{
	dir = 4
	},
/obj/structure/disposalpipe/segment{
	dir = 10
	},
/turf/simulated/floor/lubed,
/area/ruin/powered/clownplanet)
"aH" = (
/obj/effect/decal/cleanable/dirt,
/obj/machinery/light/small{
	dir = 8
	},
/obj/effect/turf_decal/tile/yellow,
/obj/effect/turf_decal/tile/yellow{
	dir = 1
	},
/obj/effect/turf_decal/tile/yellow{
	dir = 8
	},
/obj/effect/turf_decal/tile/yellow{
	dir = 4
	},
/obj/structure/disposalpipe/segment{
	dir = 10
	},
/turf/simulated/floor/lubed,
/area/ruin/powered/clownplanet)
"aM" = (
/obj/effect/decal/cleanable/pie_smudge,
/obj/effect/turf_decal/tile/yellow,
/obj/effect/turf_decal/tile/yellow{
	dir = 1
	},
/obj/effect/turf_decal/tile/yellow{
	dir = 8
	},
/obj/effect/turf_decal/tile/yellow{
	dir = 4
	},
/turf/simulated/floor/lubed,
/area/ruin/powered/clownplanet)
"aO" = (
/obj/effect/decal/cleanable/dirt,
/obj/effect/turf_decal/tile/yellow,
/obj/effect/turf_decal/tile/yellow{
	dir = 1
	},
/obj/effect/turf_decal/tile/yellow{
	dir = 8
	},
/obj/effect/turf_decal/tile/yellow{
	dir = 4
	},
/obj/structure/disposalpipe/segment{
	dir = 6
	},
/turf/simulated/floor/lubed,
/area/ruin/powered/clownplanet)
"aS" = (
/obj/effect/decal/cleanable/pie_smudge,
/obj/effect/turf_decal/tile/yellow,
/obj/effect/turf_decal/tile/yellow{
	dir = 1
	},
/obj/effect/turf_decal/tile/yellow{
	dir = 8
	},
/obj/effect/turf_decal/tile/yellow{
	dir = 4
	},
/obj/structure/disposalpipe/segment{
	dir = 10
	},
/turf/simulated/floor/lubed,
/area/ruin/powered/clownplanet)
"aU" = (
/obj/effect/spawner/window/reinforced,
/turf/simulated/floor/plating,
/area/ruin/powered/clownplanet)
"aX" = (
/obj/structure/disposalpipe/trunk{
	dir = 4
	},
/obj/structure/disposaloutlet{
	dir = 8
	},
/turf/simulated/floor/plating,
/area/ruin/powered/clownplanet)
"bc" = (
/turf/simulated/floor/light,
/area/ruin/powered/clownplanet)
"bf" = (
/turf/simulated/mineral/clown/volcanic,
/area/ruin/powered/clownplanet)
"bi" = (
/obj/effect/turf_decal/tile/red,
/obj/effect/turf_decal/tile/red{
	dir = 8
	},
/obj/effect/turf_decal/tile/red{
	dir = 4
	},
/obj/effect/turf_decal/tile/red{
	dir = 1
	},
/obj/structure/disposalpipe/segment{
	dir = 6
	},
/turf/simulated/floor/plasteel,
/area/ruin/powered/clownplanet)
"bj" = (
/obj/effect/decal/cleanable/dirt,
/obj/effect/turf_decal/tile/yellow,
/obj/effect/turf_decal/tile/yellow{
	dir = 1
	},
/obj/effect/turf_decal/tile/yellow{
	dir = 8
	},
/obj/effect/turf_decal/tile/yellow{
	dir = 4
	},
/obj/structure/disposalpipe/segment{
	dir = 10
	},
/turf/simulated/floor/lubed,
/area/ruin/powered/clownplanet)
"bk" = (
/obj/structure/disposalpipe/segment{
	dir = 5
	},
/turf/simulated/floor/plating,
/area/ruin/powered/clownplanet)
"bl" = (
/obj/item/bikehorn,
/obj/effect/turf_decal/tile/yellow,
/obj/effect/turf_decal/tile/yellow{
	dir = 1
	},
/obj/effect/turf_decal/tile/yellow{
	dir = 8
	},
/obj/effect/turf_decal/tile/yellow{
	dir = 4
	},
/obj/structure/disposalpipe/segment{
	dir = 10
	},
/turf/simulated/floor/lubed,
/area/ruin/powered/clownplanet)
"bn" = (
/obj/effect/decal/cleanable/cobweb,
/obj/effect/turf_decal/tile/red,
/obj/effect/turf_decal/tile/red{
	dir = 8
	},
/obj/effect/turf_decal/tile/red{
	dir = 4
	},
/obj/effect/turf_decal/tile/red{
	dir = 1
	},
/turf/simulated/floor/plasteel,
/area/ruin/powered/clownplanet)
"bo" = (
/obj/structure/disposalpipe/segment,
/obj/effect/turf_decal/tile/yellow,
/obj/effect/turf_decal/tile/yellow{
	dir = 1
	},
/obj/effect/turf_decal/tile/yellow{
	dir = 8
	},
/obj/effect/turf_decal/tile/yellow{
	dir = 4
	},
/turf/simulated/floor/lubed,
/area/ruin/powered/clownplanet)
"bp" = (
/obj/effect/decal/cleanable/pie_smudge,
/obj/effect/turf_decal/tile/yellow{
	dir = 4
	},
/obj/effect/turf_decal/tile/yellow{
	dir = 8
	},
/obj/effect/turf_decal/tile/yellow{
	dir = 1
	},
/obj/effect/turf_decal/tile/yellow,
/turf/simulated/floor/lubed,
/area/ruin/powered/clownplanet)
"br" = (
/obj/effect/turf_decal/tile/red,
/obj/effect/turf_decal/tile/red{
	dir = 8
	},
/obj/effect/turf_decal/tile/red{
	dir = 4
	},
/obj/effect/turf_decal/tile/red{
	dir = 1
	},
/turf/simulated/floor/plasteel,
/area/ruin/powered/clownplanet)
"bs" = (
/obj/machinery/light{
	dir = 1
	},
/obj/effect/turf_decal/tile/red,
/obj/effect/turf_decal/tile/red{
	dir = 8
	},
/obj/effect/turf_decal/tile/red{
	dir = 4
	},
/obj/effect/turf_decal/tile/red{
	dir = 1
	},
/turf/simulated/floor/plasteel,
/area/ruin/powered/clownplanet)
"bt" = (
/obj/effect/decal/cleanable/dirt,
/obj/effect/turf_decal/tile/yellow,
/obj/effect/turf_decal/tile/yellow{
	dir = 1
	},
/obj/effect/turf_decal/tile/yellow{
	dir = 8
	},
/obj/effect/turf_decal/tile/yellow{
	dir = 4
	},
/obj/structure/disposalpipe/junction/yjunction{
	dir = 1
	},
/turf/simulated/floor/lubed,
/area/ruin/powered/clownplanet)
"bu" = (
/obj/effect/decal/cleanable/blood/oil,
/obj/structure/disposalpipe/segment{
	dir = 10
	},
/turf/simulated/floor/plating,
/area/ruin/powered/clownplanet)
"bv" = (
/obj/effect/mob_spawn/human/corpse/damaged,
/obj/effect/decal/cleanable/blood/old,
/obj/effect/turf_decal/tile/yellow{
	dir = 8
	},
/obj/effect/turf_decal/tile/yellow{
	dir = 1
	},
/obj/effect/turf_decal/tile/yellow,
/obj/effect/turf_decal/tile/yellow{
	dir = 4
	},
/turf/simulated/floor/lubed,
/area/ruin/powered/clownplanet)
"bw" = (
/obj/effect/turf_decal/tile/red,
/obj/effect/turf_decal/tile/red{
	dir = 8
	},
/obj/effect/turf_decal/tile/red{
	dir = 4
	},
/obj/effect/turf_decal/tile/red{
	dir = 1
	},
/obj/structure/disposalpipe/segment{
	dir = 9
	},
/turf/simulated/floor/plasteel,
/area/ruin/powered/clownplanet)
"bx" = (
/obj/effect/decal/cleanable/dirt,
/obj/effect/turf_decal/tile/yellow,
/obj/effect/turf_decal/tile/yellow{
	dir = 1
	},
/obj/effect/turf_decal/tile/yellow{
	dir = 8
	},
/obj/effect/turf_decal/tile/yellow{
	dir = 4
	},
/obj/effect/baseturf_helper/lava_land/surface,
/turf/simulated/floor/lubed,
/area/ruin/powered/clownplanet)
"by" = (
/obj/structure/table/glass,
/obj/item/gun/magic/wand/slipping,
/turf/simulated/floor/carpet,
/area/ruin/powered/clownplanet)
"bB" = (
/turf/simulated/floor/mineral/bananium/lubed,
/area/ruin/powered/clownplanet)
"bH" = (
/obj/effect/decal/cleanable/dirt,
/turf/simulated/floor/mineral/bananium/lubed,
/area/ruin/powered/clownplanet)
"bL" = (
/obj/item/reagent_containers/food/drinks/trophy/gold_cup,
/obj/structure/table/glass,
/turf/simulated/floor/carpet,
/area/ruin/powered/clownplanet)
"bM" = (
/turf/simulated/floor/carpet,
/area/ruin/powered/clownplanet)
"bN" = (
/obj/machinery/disposal/deliveryChute,
/obj/structure/disposalpipe/trunk{
	dir = 1
	},
/turf/simulated/floor/carpet,
/area/ruin/powered/clownplanet)
"bO" = (
/obj/effect/decal/cleanable/cobweb,
/turf/simulated/floor/mineral/bananium/lubed,
/area/ruin/powered/clownplanet)
"bP" = (
/obj/structure/statue/bananium/clown,
/turf/simulated/floor/carpet,
/area/ruin/powered/clownplanet)
"bQ" = (
/obj/structure/table/glass,
/obj/item/grown/bananapeel/bluespace,
/turf/simulated/floor/carpet,
/area/ruin/powered/clownplanet)
"bR" = (
/obj/structure/table/glass,
/obj/item/clothing/shoes/magboots/clown,
/turf/simulated/floor/carpet,
/area/ruin/powered/clownplanet)
"bS" = (
/obj/item/coin/clown,
/obj/item/coin/clown,
/obj/item/coin/clown,
/obj/item/coin/clown,
/obj/machinery/light/small{
	dir = 8
	},
/turf/simulated/floor/carpet,
/area/ruin/powered/clownplanet)
"bT" = (
/obj/item/slime_extract/rainbow,
/obj/structure/table/glass,
/turf/simulated/floor/carpet,
/area/ruin/powered/clownplanet)
"bU" = (
/obj/item/bikehorn/airhorn,
/turf/simulated/floor/carpet,
/area/ruin/powered/clownplanet)
"bW" = (
/obj/item/bikehorn,
/turf/simulated/floor/mineral/bananium/lubed,
/area/ruin/powered/clownplanet)
"bY" = (
/obj/effect/mob_spawn/human/corpse/damaged,
/obj/effect/decal/cleanable/blood/old,
/turf/simulated/floor/mineral/bananium/lubed,
/area/ruin/powered/clownplanet)
"bZ" = (
/obj/machinery/door/airlock/bananium,
/turf/simulated/floor/mineral/bananium/lubed,
/area/ruin/powered/clownplanet)
"ca" = (
/obj/item/bikehorn,
/obj/effect/decal/cleanable/dirt,
/turf/simulated/floor/mineral/bananium/lubed,
/area/ruin/powered/clownplanet)
"cc" = (
/turf/simulated/wall/r_wall,
/area/ruin/powered/clownplanet)
"cu" = (
/turf/simulated/floor/plating,
/area/ruin/powered/clownplanet)
"dy" = (
/obj/effect/decal/cleanable/pie_smudge,
/obj/structure/disposalpipe/segment,
/obj/effect/turf_decal/tile/yellow,
/obj/effect/turf_decal/tile/yellow{
	dir = 1
	},
/obj/effect/turf_decal/tile/yellow{
	dir = 8
	},
/obj/effect/turf_decal/tile/yellow{
	dir = 4
	},
/turf/simulated/floor/lubed,
/area/ruin/powered/clownplanet)
"dK" = (
/obj/machinery/light/small{
	dir = 1
	},
/turf/simulated/floor/carpet,
/area/ruin/powered/clownplanet)
"dL" = (
/obj/item/coin/clown,
/obj/item/coin/clown,
/obj/item/coin/clown,
/obj/item/coin/clown,
/obj/machinery/light/small{
	dir = 4
	},
/turf/simulated/floor/carpet,
/area/ruin/powered/clownplanet)
"dM" = (
/obj/machinery/light{
	dir = 1
	},
/turf/simulated/floor/mineral/bananium/lubed,
/area/ruin/powered/clownplanet)
"dO" = (
/obj/machinery/light,
/turf/simulated/floor/mineral/bananium/lubed,
/area/ruin/powered/clownplanet)
"et" = (
/obj/structure/disposalpipe/segment{
	dir = 4
	},
/obj/machinery/light/small{
	dir = 8
	},
/turf/simulated/floor/plasteel{
	icon_state = "white"
	},
/area/ruin/powered/clownplanet)
"eX" = (
/obj/effect/mapping_helpers/no_lava,
/turf/simulated/floor/noslip/lavaland,
/area/lavaland/surface/outdoors/explored)
"gX" = (
/obj/effect/mapping_helpers/no_lava,
/turf/simulated/floor/chasm/straight_down/lava_land_surface,
/area/lavaland/surface/outdoors/explored)
"hY" = (
/obj/machinery/light,
/obj/effect/mapping_helpers/no_lava,
/turf/simulated/floor/plating/asteroid/basalt/lava_land_surface,
/area/ruin/powered/clownplanet)
"iQ" = (
/obj/structure/disposalpipe/segment{
	dir = 4
	},
/obj/effect/decal/cleanable/cobweb,
/obj/effect/turf_decal/tile/yellow,
/obj/effect/turf_decal/tile/yellow{
	dir = 1
	},
/obj/effect/turf_decal/tile/yellow{
	dir = 8
	},
/obj/effect/turf_decal/tile/yellow{
	dir = 4
	},
/turf/simulated/floor/lubed,
/area/ruin/powered/clownplanet)
"kG" = (
/obj/item/bikehorn,
/obj/structure/disposalpipe/segment,
/obj/effect/turf_decal/tile/yellow,
/obj/effect/turf_decal/tile/yellow{
	dir = 1
	},
/obj/effect/turf_decal/tile/yellow{
	dir = 8
	},
/obj/effect/turf_decal/tile/yellow{
	dir = 4
	},
/turf/simulated/floor/lubed,
/area/ruin/powered/clownplanet)
"mZ" = (
/obj/structure/disposalpipe/segment{
	dir = 4
	},
/turf/simulated/floor/plasteel{
	icon_state = "white"
	},
/area/ruin/powered/clownplanet)
"nf" = (
/obj/structure/disposalpipe/segment{
	dir = 4
	},
/obj/machinery/light/small{
	dir = 4
	},
/turf/simulated/floor/plasteel{
	icon_state = "white"
	},
/area/ruin/powered/clownplanet)
"np" = (
/turf/simulated/floor/lava,
/area/ruin/powered/clownplanet)
"pv" = (
/obj/machinery/light{
	dir = 4
	},
/obj/effect/mapping_helpers/no_lava,
/turf/simulated/floor/plating/asteroid/basalt/lava_land_surface,
/area/ruin/powered/clownplanet)
"qE" = (
/obj/item/bikehorn,
/obj/structure/disposalpipe/segment{
	dir = 4
	},
/obj/effect/turf_decal/tile/yellow,
/obj/effect/turf_decal/tile/yellow{
	dir = 1
	},
/obj/effect/turf_decal/tile/yellow{
	dir = 8
	},
/obj/effect/turf_decal/tile/yellow{
	dir = 4
	},
/turf/simulated/floor/lubed,
/area/ruin/powered/clownplanet)
"sj" = (
/obj/structure/disposalpipe/segment{
	dir = 4
	},
/obj/structure/table,
/obj/item/flashlight/lamp/bananalamp,
/turf/simulated/floor/plasteel{
	icon_state = "white"
	},
/area/ruin/powered/clownplanet)
"ti" = (
/obj/structure/disposalpipe/segment{
	dir = 4
	},
/obj/effect/turf_decal/tile/yellow,
/obj/effect/turf_decal/tile/yellow{
	dir = 1
	},
/obj/effect/turf_decal/tile/yellow{
	dir = 8
	},
/obj/effect/turf_decal/tile/yellow{
	dir = 4
	},
/turf/simulated/floor/lubed,
/area/ruin/powered/clownplanet)
"tj" = (
/obj/structure/mecha_wreckage/honker,
/obj/structure/disposalpipe/segment{
	dir = 4
	},
/turf/simulated/floor/plating,
/area/ruin/powered/clownplanet)
"um" = (
/obj/machinery/disposal/deliveryChute{
	dir = 1
	},
/obj/structure/disposalpipe/trunk,
/turf/simulated/floor/plasteel{
	icon_state = "white"
	},
/area/ruin/powered/clownplanet)
"uT" = (
/obj/structure/disposalpipe/segment{
	dir = 4
	},
/turf/simulated/floor/plating,
/area/ruin/powered/clownplanet)
"ve" = (
/obj/structure/disposalpipe/segment{
	dir = 6
	},
/turf/simulated/floor/plasteel{
	icon_state = "white"
	},
/area/ruin/powered/clownplanet)
"vn" = (
/obj/item/bikehorn,
/obj/effect/decal/cleanable/dirt,
/obj/structure/disposalpipe/segment,
/obj/effect/turf_decal/tile/yellow,
/obj/effect/turf_decal/tile/yellow{
	dir = 1
	},
/obj/effect/turf_decal/tile/yellow{
	dir = 8
	},
/obj/effect/turf_decal/tile/yellow{
	dir = 4
	},
/turf/simulated/floor/lubed,
/area/ruin/powered/clownplanet)
"wC" = (
/obj/machinery/light/small{
	dir = 4
	},
/obj/structure/disposalpipe/segment{
	dir = 9
	},
/turf/simulated/floor/plasteel{
	icon_state = "white"
	},
/area/ruin/powered/clownplanet)
"zo" = (
/obj/structure/disposalpipe/segment{
	dir = 4
	},
/obj/structure/table,
/obj/item/paper/crumpled/bloody/ruins/lavaland/clown_planet/escape,
/obj/item/pen/multi,
/turf/simulated/floor/plasteel{
	icon_state = "white"
	},
/area/ruin/powered/clownplanet)
"Aj" = (
/obj/structure/disposalpipe/segment{
	dir = 5
	},
/turf/simulated/floor/plasteel{
	icon_state = "white"
	},
/area/ruin/powered/clownplanet)
"CB" = (
/obj/item/paper/crumpled/bloody/ruins/lavaland/clown_planet/hope,
/obj/effect/decal/cleanable/blood/old,
/obj/effect/mapping_helpers/no_lava,
/turf/simulated/floor/noslip/lavaland,
/area/lavaland/surface/outdoors/explored)
"Dl" = (
/obj/structure/disposalpipe/segment{
	dir = 10
	},
/turf/simulated/floor/plasteel{
	icon_state = "white"
	},
/area/ruin/powered/clownplanet)
"EQ" = (
/obj/effect/mob_spawn/human/corpse/damaged,
/obj/effect/decal/cleanable/blood/old,
/obj/structure/disposalpipe/segment,
/obj/effect/turf_decal/tile/yellow,
/obj/effect/turf_decal/tile/yellow{
	dir = 1
	},
/obj/effect/turf_decal/tile/yellow{
	dir = 8
	},
/obj/effect/turf_decal/tile/yellow{
	dir = 4
	},
/turf/simulated/floor/lubed,
/area/ruin/powered/clownplanet)
"Hf" = (
/turf/simulated/floor/plasteel{
	icon_state = "white"
	},
/area/ruin/powered/clownplanet)
"Id" = (
/obj/item/pickaxe,
/turf/simulated/floor/plasteel{
	icon_state = "white"
	},
/area/ruin/powered/clownplanet)
"Jp" = (
/obj/structure/disposalpipe/segment{
	dir = 4
	},
/obj/item/pickaxe,
/turf/simulated/floor/plasteel{
	icon_state = "white"
	},
/area/ruin/powered/clownplanet)
"KK" = (
/obj/structure/disposalpipe/segment{
	dir = 4
	},
/turf/simulated/wall/r_wall,
/area/ruin/powered/clownplanet)
"KX" = (
/obj/item/grown/bananapeel{
	color = "#2F3000";
	name = "stealth banana peel"
	},
/obj/effect/mapping_helpers/no_lava,
/turf/simulated/floor/plating/asteroid/basalt/lava_land_surface,
/area/lavaland/surface/outdoors/explored)
"Ld" = (
/obj/structure/disposalpipe/segment{
	dir = 4
	},
/obj/effect/decal/cleanable/dirt,
/obj/effect/turf_decal/tile/yellow,
/obj/effect/turf_decal/tile/yellow{
	dir = 1
	},
/obj/effect/turf_decal/tile/yellow{
	dir = 8
	},
/obj/effect/turf_decal/tile/yellow{
	dir = 4
	},
/turf/simulated/floor/lubed,
/area/ruin/powered/clownplanet)
"Lp" = (
/obj/effect/decal/cleanable/dirt,
/obj/structure/disposalpipe/segment,
/obj/effect/turf_decal/tile/yellow,
/obj/effect/turf_decal/tile/yellow{
	dir = 1
	},
/obj/effect/turf_decal/tile/yellow{
	dir = 8
	},
/obj/effect/turf_decal/tile/yellow{
	dir = 4
	},
/turf/simulated/floor/lubed,
/area/ruin/powered/clownplanet)
"LH" = (
/obj/machinery/disposal/deliveryChute{
	desc = "The following is engraved upon the chute: A FATE WORSE THAN DEATH LIES WITHIN";
	dir = 1;
	name = "THE TRIAL OF HONKITUDE"
	},
/obj/structure/disposalpipe/trunk,
/obj/effect/mapping_helpers/no_lava,
/turf/simulated/floor/noslip/lavaland,
/area/ruin/powered/clownplanet)
"LI" = (
/obj/structure/disposalpipe/segment{
	dir = 4
	},
/obj/effect/decal/cleanable/pie_smudge,
/obj/effect/turf_decal/tile/yellow,
/obj/effect/turf_decal/tile/yellow{
	dir = 1
	},
/obj/effect/turf_decal/tile/yellow{
	dir = 8
	},
/obj/effect/turf_decal/tile/yellow{
	dir = 4
	},
/turf/simulated/floor/lubed,
/area/ruin/powered/clownplanet)
"LR" = (
/obj/structure/disposalpipe/segment,
/turf/simulated/floor/plating,
/area/ruin/powered/clownplanet)
"Mv" = (
/obj/effect/mapping_helpers/no_lava,
/mob/living/simple_animal/hostile/retaliate/clown,
/turf/simulated/floor/plating/asteroid/basalt/lava_land_surface,
/area/lavaland/surface/outdoors/explored)
"MR" = (
/obj/machinery/light{
	dir = 8
	},
/obj/effect/mapping_helpers/no_lava,
/turf/simulated/floor/plating/asteroid/basalt/lava_land_surface,
/area/ruin/powered/clownplanet)
"NJ" = (
/obj/structure/disposalpipe/segment{
	dir = 9
	},
/turf/simulated/floor/plasteel{
	icon_state = "white"
	},
/area/ruin/powered/clownplanet)
"RV" = (
/obj/structure/disposalpipe/segment{
	dir = 4
	},
/obj/effect/turf_decal/tile/red,
/obj/effect/turf_decal/tile/red{
	dir = 8
	},
/obj/effect/turf_decal/tile/red{
	dir = 4
	},
/obj/effect/turf_decal/tile/red{
	dir = 1
	},
/turf/simulated/floor/plasteel,
/area/ruin/powered/clownplanet)
"TD" = (
/obj/structure/disposalpipe/trunk,
/obj/structure/disposaloutlet{
	dir = 1
	},
/obj/effect/mapping_helpers/no_lava,
/turf/simulated/floor/noslip/lavaland,
/area/ruin/powered/clownplanet)
"Vp" = (
/obj/structure/disposalpipe/segment,
/turf/simulated/wall/r_wall,
/area/ruin/powered/clownplanet)
"VH" = (
/obj/structure/disposalpipe/segment{
	dir = 9
	},
/turf/simulated/wall/r_wall,
/area/ruin/powered/clownplanet)
"VN" = (
/obj/structure/disposalpipe/segment{
	dir = 4
	},
/turf/simulated/floor/light,
/area/ruin/powered/clownplanet)
"Wa" = (
/obj/structure/disposalpipe/segment,
/obj/machinery/light/small{
	dir = 8
	},
/turf/simulated/floor/plasteel{
	icon_state = "white"
	},
/area/ruin/powered/clownplanet)
"WW" = (
/obj/structure/disposalpipe/segment,
/obj/machinery/light/small{
	dir = 1
	},
/obj/effect/turf_decal/tile/yellow,
/obj/effect/turf_decal/tile/yellow{
	dir = 1
	},
/obj/effect/turf_decal/tile/yellow{
	dir = 8
	},
/obj/effect/turf_decal/tile/yellow{
	dir = 4
	},
/turf/simulated/floor/lubed,
/area/ruin/powered/clownplanet)
"Xm" = (
/obj/item/clothing/head/cone,
/obj/effect/mapping_helpers/no_lava,
/turf/simulated/floor/noslip/lavaland,
/area/lavaland/surface/outdoors/explored)
"XO" = (
/obj/effect/mapping_helpers/no_lava,
/turf/simulated/floor/plating/asteroid/basalt/lava_land_surface,
/area/lavaland/surface/outdoors/explored)
"Yf" = (
/obj/machinery/light{
	dir = 1
	},
/obj/effect/mapping_helpers/no_lava,
/turf/simulated/floor/plating/asteroid/basalt/lava_land_surface,
/area/ruin/powered/clownplanet)
"YI" = (
/obj/machinery/light/small,
/obj/effect/mapping_helpers/no_lava,
/turf/simulated/floor/noslip/lavaland,
/area/ruin/powered/clownplanet)

(1,1,1) = {"
aa
aa
aa
aa
aa
aa
aa
aa
aa
aa
aa
aa
aa
aa
aa
XO
XO
XO
XO
XO
aa
aa
aa
aa
aa
aa
aa
aa
aa
aa
aa
aa
"}
(2,1,1) = {"
aa
aa
aa
aa
aa
aa
aa
cc
cc
cc
cc
cc
cc
cc
pv
XO
gX
XO
XO
gX
pv
cc
cc
cc
cc
cc
aa
aa
aa
aa
aa
aa
"}
(3,1,1) = {"
aa
aa
aa
aa
aa
cc
cc
cc
np
np
np
np
np
cc
cc
gX
gX
KX
gX
gX
cc
cc
np
np
np
cc
cc
cc
aa
aa
aa
aa
"}
(4,1,1) = {"
aa
aa
aa
aa
cc
cc
np
np
np
ab
aA
ab
aA
np
cc
cc
gX
gX
gX
cc
cc
np
np
aU
cu
np
np
cc
cc
aa
aa
aa
"}
(5,1,1) = {"
aa
aa
aa
cc
cc
np
np
ab
Vp
VH
aH
ay
aS
aA
np
cc
cc
cc
cc
cc
bO
bB
aU
np
np
np
np
np
cc
cc
aa
aa
"}
(6,1,1) = {"
aa
aa
aa
cc
np
np
cc
iQ
ah
bo
vn
bo
av
KK
np
cc
bB
bH
bB
cc
bB
bH
bY
bB
aU
np
aU
np
np
cc
Yf
aa
"}
(7,1,1) = {"
aa
aa
cc
cc
np
ab
dy
ap
Ld
ah
bo
aA
KK
KK
cc
bn
br
bB
bH
bH
bB
bH
bB
bB
bB
cc
np
cu
np
cc
cc
aa
"}
(8,1,1) = {"
aa
aa
cc
np
np
ae
bo
av
Ld
KK
aX
KK
mZ
et
bf
cc
bs
br
bB
cc
cc
bH
cc
bB
bB
bB
aU
np
np
np
cc
aa
"}
(9,1,1) = {"
aa
aa
cc
np
ab
bo
bo
ay
ti
ti
KK
mZ
mZ
mZ
Id
bf
cc
cc
br
bB
bB
bH
bB
bB
ca
bH
dO
cc
np
np
cc
aa
"}
(10,1,1) = {"
aa
Mv
cc
np
ac
EQ
bo
av
KK
Ld
KK
mZ
mZ
VN
bc
Hf
br
br
br
bB
cc
bB
bB
bH
bH
bB
bB
np
aU
np
cc
cc
"}
(11,1,1) = {"
aa
hY
cc
np
ad
Vp
WW
ay
Ld
Ld
KK
mZ
Jp
VN
bc
bf
cc
br
br
bB
bB
cc
bB
bB
bB
bB
bH
np
aU
np
np
cc
"}
(12,1,1) = {"
aa
Mv
cc
np
ae
bo
bo
az
Ld
ac
ap
KK
mZ
nf
Hf
cc
cc
br
bB
bB
cc
cc
bB
bB
cc
bB
bH
np
cu
aU
np
cc
"}
(13,1,1) = {"
XO
Mv
cc
np
cc
ah
bo
ap
aC
dy
bo
ap
KK
KK
bi
Vp
aA
cc
cc
cc
bP
bS
cc
dM
bB
bH
ca
bB
np
aU
np
cc
"}
(14,1,1) = {"
XO
Xm
cc
cc
np
ac
bo
bo
bo
bo
kG
bo
ay
ti
bj
al
Ld
cc
cc
bL
bM
bM
bM
cc
bB
bH
bH
bB
np
aU
np
cc
"}
(15,1,1) = {"
eX
eX
LH
Vp
Vp
LR
bo
Vp
bo
Lp
Vp
dy
bo
ay
as
ti
aC
av
cc
dK
bQ
bT
bM
cc
cc
bH
bB
bB
np
aU
np
cc
"}
(16,1,1) = {"
eX
CB
YI
cc
np
cu
ah
aA
ah
av
ah
bo
bo
LR
bk
aC
av
bj
Vp
bN
bM
bU
bM
bZ
bB
bH
bB
cc
np
aU
np
cc
"}
(17,1,1) = {"
eX
eX
TD
Vp
Vp
ai
ay
ti
ti
KK
ti
aO
bo
av
bl
bo
bt
bx
cc
bM
bR
by
bM
cc
bB
bB
bB
bB
np
aU
np
cc
"}
(18,1,1) = {"
XO
eX
cc
cc
np
KK
as
Ld
Ld
ti
ti
ti
ar
aC
av
bp
KK
bv
cc
bL
bM
bM
bM
cc
bB
bB
bB
bB
np
aU
np
cc
"}
(19,1,1) = {"
XO
Mv
cc
np
np
KK
as
Ld
qE
ti
ti
KK
cc
cc
RV
cc
tj
cc
bB
cc
bP
dL
cc
dM
bB
bH
bH
bB
np
aU
np
cc
"}
(20,1,1) = {"
aa
Mv
cc
np
cc
KK
ar
ti
ti
Ld
ti
KK
ve
Wa
NJ
cc
bu
aA
bB
bB
cc
cc
bY
bB
bB
bH
bB
np
aU
cu
np
cc
"}
(21,1,1) = {"
aa
hY
cc
np
cc
KK
aw
LI
KK
Ld
KK
zo
mZ
bc
bc
bf
cc
RV
br
bB
bB
cc
bB
bH
bB
bB
bB
np
aU
np
np
cc
"}
(22,1,1) = {"
aa
Mv
cc
np
aq
ao
ar
KK
uT
Ld
KK
sj
mZ
bc
bc
um
Vp
bw
cc
bB
bB
bH
bH
bH
bB
bW
dO
cc
aU
np
cc
cc
"}
(23,1,1) = {"
aa
aa
cc
np
cc
cc
ar
ti
ti
qE
RV
mZ
Dl
Aj
Hf
bf
cc
br
br
bB
bB
bH
bH
bB
bB
cc
cc
np
cu
np
cc
aa
"}
(24,1,1) = {"
aa
aa
cc
np
cc
cc
as
ti
KK
ti
KK
KK
ve
wC
bf
cc
bs
br
bB
bB
bB
bB
bB
cc
bB
bB
np
cu
np
np
cc
aa
"}
(25,1,1) = {"
aa
aa
cc
np
np
cc
ar
ti
ti
ti
aC
ap
KK
cc
cc
br
br
bB
bB
bB
bH
bW
bB
bB
bB
cc
np
aU
np
cc
cc
aa
"}
(26,1,1) = {"
aa
aa
cc
cc
np
cc
cc
aC
ap
aG
bo
bo
aE
cc
np
cc
bO
bB
bB
cc
bB
bB
cc
bB
bB
np
cu
np
np
cc
Yf
aa
"}
(27,1,1) = {"
aa
aa
aa
cc
cc
np
np
cc
cu
cc
aM
ar
cu
cc
np
cc
cc
cc
cc
cc
bB
bB
bB
np
np
np
np
np
cc
cc
aa
aa
"}
(28,1,1) = {"
aa
aa
aa
aa
cc
cc
np
np
np
aU
aU
aU
cc
np
cc
cc
gX
gX
gX
cc
cc
np
np
cu
aU
np
np
cc
cc
aa
aa
aa
"}
(29,1,1) = {"
aa
aa
aa
aa
aa
cc
cc
cc
np
np
np
np
np
cc
cc
gX
gX
KX
gX
gX
cc
cc
np
np
np
cc
cc
cc
aa
aa
aa
aa
"}
(30,1,1) = {"
aa
aa
aa
aa
aa
aa
aa
cc
cc
cc
cc
cc
cc
cc
MR
XO
XO
XO
XO
gX
MR
cc
cc
cc
cc
cc
aa
aa
aa
aa
aa
aa
"}
(31,1,1) = {"
aa
aa
aa
aa
aa
aa
aa
aa
aa
aa
aa
aa
aa
aa
aa
XO
gX
XO
XO
XO
aa
aa
aa
aa
aa
aa
aa
aa
aa
aa
aa
aa
"}
