//MAP CONVERTED BY dmm2tgm.py THIS HEADER COMMENT PREVENTS RECONVERSION, DO NOT REMOVE
"aj" = (
/obj/structure/stone_tile/block/cracked{
	dir = 1
	},
/obj/effect/mapping_helpers/no_lava,
/turf/simulated/floor/plating/asteroid/basalt/lava_land_surface,
/area/ruin/unpowered/drake)
"aS" = (
/obj/structure/flora/rock/lava2,
/obj/effect/mapping_helpers/no_lava,
/turf/simulated/floor/plating/asteroid/basalt/lava_land_surface,
/area/ruin/unpowered/drake)
"bB" = (
/turf/simulated/floor/plating/lava/smooth/lava_land_surface,
/area/lavaland/surface/outdoors)
"bV" = (
/obj/structure/bones/ribs_right,
/obj/effect/mapping_helpers/no_lava,
/turf/simulated/floor/plating/asteroid/basalt/lava_land_surface,
/area/ruin/unpowered/drake)
"de" = (
/obj/structure/flora/rock/lava2,
/obj/structure/stone_tile/cracked,
/obj/effect/mapping_helpers/no_lava,
/turf/simulated/floor/plating/asteroid/basalt/lava_land_surface,
/area/ruin/unpowered/drake)
"dv" = (
/obj/structure/stone_tile/cracked,
/turf/simulated/floor/plating/lava/smooth/lava_land_surface,
/area/lavaland/surface/outdoors)
"dw" = (
/obj/structure/stone_tile{
	dir = 8
	},
/obj/structure/stone_tile/block/cracked{
	dir = 4
	},
/obj/structure/stone_tile/cracked{
	dir = 4
	},
/turf/simulated/floor/plating/lava/smooth/lava_land_surface,
/area/lavaland/surface/outdoors)
"ed" = (
/obj/structure/bones/right,
/obj/effect/mapping_helpers/no_lava,
/turf/simulated/floor/plating/asteroid/basalt/lava_land_surface,
/area/ruin/unpowered/drake)
"eu" = (
/obj/structure/flora/rock/basalt2,
/obj/effect/mapping_helpers/no_lava,
/turf/simulated/floor/plating/asteroid/basalt/lava_land_surface,
/area/ruin/unpowered/drake)
"ey" = (
/obj/structure/flora/rock/basalt1,
/obj/effect/mapping_helpers/no_lava,
/turf/simulated/floor/plating/asteroid/basalt/lava_land_surface,
/area/ruin/unpowered/drake)
"fw" = (
/obj/structure/flora/rock/lava2,
/obj/structure/stone_tile/cracked,
/obj/structure/stone_tile/cracked{
	dir = 4
	},
/obj/effect/mapping_helpers/no_lava,
/turf/simulated/floor/plating/asteroid/basalt/lava_land_surface,
/area/ruin/unpowered/drake)
"fF" = (
/obj/structure/flora/rock/basalt4,
/obj/effect/mapping_helpers/no_lava,
/turf/simulated/floor/plating/asteroid/basalt/lava_land_surface,
/area/ruin/unpowered/drake)
"gY" = (
/obj/effect/mapping_helpers/no_lava,
/turf/simulated/floor/plating/asteroid/basalt/lava_land_surface,
/area/ruin/unpowered/drake)
"hx" = (
/obj/effect/mapping_helpers/no_lava,
/turf/simulated/floor/plating/lava/smooth/lava_land_surface,
/area/ruin/unpowered/drake)
"hQ" = (
/obj/structure/stone_tile/cracked{
	dir = 1
	},
/turf/simulated/floor/plating/lava/smooth/lava_land_surface,
/area/lavaland/surface/outdoors)
"ja" = (
/obj/structure/flora/rock/basalt3,
/obj/effect/mapping_helpers/no_lava,
/turf/simulated/floor/plating/asteroid/basalt/lava_land_surface,
/area/ruin/unpowered/drake)
"kh" = (
/obj/structure/stone_tile/cracked,
/obj/effect/mapping_helpers/no_lava,
/obj/effect/mapping_helpers/no_lava,
/turf/simulated/floor/plating/asteroid/basalt/lava_land_surface,
/area/ruin/unpowered/drake)
"kN" = (
/obj/structure/stone_tile/cracked{
	dir = 8
	},
/obj/effect/mapping_helpers/no_lava,
/turf/simulated/floor/plating/asteroid/basalt/lava_land_surface,
/area/lavaland/surface/outdoors)
"lW" = (
/obj/structure/stone_tile/block/cracked,
/turf/simulated/floor/plating/lava/smooth/lava_land_surface,
/area/lavaland/surface/outdoors)
"mm" = (
/obj/effect/baseturf_helper/lava_land/surface,
/mob/living/simple_animal/hostile/megafauna/dragon,
/turf/simulated/floor/plating/lava/smooth/lava_land_surface,
/area/ruin/unpowered/drake)
"oM" = (
/obj/structure/stone_tile{
	dir = 1
	},
/obj/effect/mapping_helpers/no_lava,
/turf/simulated/floor/plating/asteroid/basalt/lava_land_surface,
/area/lavaland/surface/outdoors)
"pH" = (
/obj/structure/flora/rock/lava3,
/obj/structure/bones/ribs_left,
/obj/effect/mapping_helpers/no_lava,
/turf/simulated/floor/plating/asteroid/basalt/lava_land_surface,
/area/ruin/unpowered/drake)
"pW" = (
/obj/structure/stone_tile{
	dir = 8
	},
/obj/effect/mapping_helpers/no_lava,
/turf/simulated/floor/plating/asteroid/basalt/lava_land_surface,
/area/lavaland/surface/outdoors)
"qj" = (
/turf/simulated/floor/plating/lava/smooth/lava_land_surface,
/area/ruin/unpowered/drake)
"qt" = (
/obj/structure/closet/crate/necropolis,
/obj/effect/mapping_helpers/no_lava,
/turf/simulated/floor/plating/asteroid/basalt/lava_land_surface,
/area/ruin/unpowered/drake)
"rV" = (
/obj/structure/stone_tile/cracked,
/obj/effect/mapping_helpers/no_lava,
/turf/simulated/floor/plating/asteroid/basalt/lava_land_surface,
/area/ruin/unpowered/drake)
"sH" = (
/obj/structure/stone_tile/block/cracked{
	dir = 4
	},
/obj/effect/mapping_helpers/no_lava,
/turf/simulated/floor/plating/asteroid/basalt/lava_land_surface,
/area/ruin/unpowered/drake)
"tj" = (
/obj/structure/stone_tile/block/cracked{
	dir = 1
	},
/obj/effect/mapping_helpers/no_lava,
/turf/simulated/floor/plating/asteroid/basalt/lava_land_surface,
/area/lavaland/surface/outdoors)
"tw" = (
/obj/effect/mapping_helpers/no_lava,
/obj/effect/mapping_helpers/no_lava,
/turf/simulated/floor/plating/asteroid/basalt/lava_land_surface,
/area/ruin/unpowered/drake)
"uO" = (
/obj/effect/mapping_helpers/no_lava,
/obj/effect/mapping_helpers/no_lava,
/turf/simulated/floor/plating/asteroid/basalt/lava_land_surface,
/area/lavaland/surface/outdoors)
"uQ" = (
/obj/structure/stone_tile{
	dir = 4
	},
/turf/simulated/floor/plating/lava/smooth/lava_land_surface,
/area/lavaland/surface/outdoors)
"wT" = (
/obj/structure/stone_tile/block/cracked{
	dir = 8
	},
/turf/simulated/floor/plating/lava/smooth/lava_land_surface,
/area/lavaland/surface/outdoors)
"xB" = (
/obj/effect/mapping_helpers/no_lava,
/turf/simulated/floor/plating/asteroid/basalt/lava_land_surface,
/area/lavaland/surface/outdoors)
"xU" = (
/obj/structure/stone_tile/cracked{
	dir = 8
	},
/obj/effect/mapping_helpers/no_lava,
/turf/simulated/floor/plating/asteroid/basalt/lava_land_surface,
/area/ruin/unpowered/drake)
"Bv" = (
/obj/structure/stone_tile{
	dir = 1
	},
/obj/effect/mapping_helpers/no_lava,
/turf/simulated/floor/plating/asteroid/basalt/lava_land_surface,
/area/ruin/unpowered/drake)
"CJ" = (
/obj/structure/stone_tile/cracked{
	dir = 8
	},
/obj/effect/mapping_helpers/no_lava,
/obj/effect/mapping_helpers/no_lava,
/turf/simulated/floor/plating/asteroid/basalt/lava_land_surface,
/area/ruin/unpowered/drake)
"CM" = (
/obj/structure/stone_tile/block/cracked,
/obj/effect/mapping_helpers/no_lava,
/turf/simulated/floor/plating/asteroid/basalt/lava_land_surface,
/area/ruin/unpowered/drake)
"Du" = (
/obj/structure/flora/rock/lava1,
/obj/effect/mapping_helpers/no_lava,
/turf/simulated/floor/plating/asteroid/basalt/lava_land_surface,
/area/ruin/unpowered/drake)
"DG" = (
/obj/structure/stone_tile/block{
	dir = 1
	},
/obj/structure/stone_tile{
	dir = 8
	},
/obj/structure/stone_tile/cracked,
/turf/simulated/floor/plating/lava/smooth/lava_land_surface,
/area/lavaland/surface/outdoors)
"DY" = (
/obj/structure/stone_tile/cracked{
	dir = 4
	},
/obj/structure/stone_tile{
	dir = 1
	},
/obj/structure/stone_tile/block,
/turf/simulated/floor/plating/lava/smooth/lava_land_surface,
/area/lavaland/surface/outdoors)
"Iq" = (
/obj/structure/stone_tile/cracked{
	dir = 4
	},
/turf/simulated/floor/plating/lava/smooth/lava_land_surface,
/area/lavaland/surface/outdoors)
"Jb" = (
/obj/structure/stone_tile{
	dir = 1
	},
/turf/simulated/floor/plating/lava/smooth/lava_land_surface,
/area/lavaland/surface/outdoors)
"Jl" = (
/obj/structure/stone_tile{
	dir = 4
	},
/obj/structure/stone_tile,
/obj/effect/mapping_helpers/no_lava,
/turf/simulated/floor/plating/asteroid/basalt/lava_land_surface,
/area/ruin/unpowered/drake)
"Lf" = (
/obj/structure/stone_tile/block/cracked{
	dir = 8
	},
/obj/effect/mapping_helpers/no_lava,
/turf/simulated/floor/plating/asteroid/basalt/lava_land_surface,
/area/ruin/unpowered/drake)
"LB" = (
/turf/simulated/floor/plating/asteroid/basalt/lava_land_surface,
/area/ruin/unpowered/drake)
"NI" = (
/obj/structure/stone_tile/block,
/obj/structure/stone_tile/cracked{
	dir = 1
	},
/obj/structure/stone_tile{
	dir = 4
	},
/turf/simulated/floor/plating/lava/smooth/lava_land_surface,
/area/lavaland/surface/outdoors)
"Oe" = (
/mob/living/simple_animal/hostile/asteroid/goliath/beast/ancient,
/obj/effect/mapping_helpers/no_lava,
/turf/simulated/floor/plating/asteroid/basalt/lava_land_surface,
/area/ruin/unpowered/drake)
"Os" = (
/turf/simulated/floor/plating/lava/smooth/lava_land_surface,
/area/ruin/unpowered/drake)
"PI" = (
/obj/structure/stone_tile{
	dir = 8
	},
/obj/structure/stone_tile{
	dir = 1
	},
/obj/effect/mapping_helpers/no_lava,
/turf/simulated/floor/plating/asteroid/basalt/lava_land_surface,
/area/ruin/unpowered/drake)
"PJ" = (
/obj/structure/bones,
/obj/effect/mapping_helpers/no_lava,
/turf/simulated/floor/plating/asteroid/basalt/lava_land_surface,
/area/ruin/unpowered/drake)
"QD" = (
/turf/simulated/wall/indestructible/boss,
/area/ruin/unpowered/drake)
"Rs" = (
/obj/structure/flora/rock/lava2,
/turf/simulated/wall/indestructible/boss,
/area/ruin/unpowered/drake)
"RQ" = (
/obj/structure/flora/rock/lava3,
/obj/effect/mapping_helpers/no_lava,
/turf/simulated/floor/plating/asteroid/basalt/lava_land_surface,
/area/ruin/unpowered/drake)
"SW" = (
/obj/structure/stone_tile{
	dir = 8
	},
/obj/effect/mapping_helpers/no_lava,
/turf/simulated/floor/plating/asteroid/basalt/lava_land_surface,
/area/ruin/unpowered/drake)
"TZ" = (
/obj/structure/stone_tile/block{
	dir = 4
	},
/obj/structure/stone_tile{
	dir = 4
	},
/obj/effect/mapping_helpers/no_lava,
/turf/simulated/floor/plating/asteroid/basalt/lava_land_surface,
/area/ruin/unpowered/drake)
"Ud" = (
/obj/structure/stone_tile/cracked,
/obj/effect/mapping_helpers/no_lava,
/turf/simulated/floor/plating/asteroid/basalt/lava_land_surface,
/area/lavaland/surface/outdoors)
"Vs" = (
/mob/living/simple_animal/hostile/asteroid/basilisk/watcher/magmawing,
/obj/effect/mapping_helpers/no_lava,
/turf/simulated/floor/plating/asteroid/basalt/lava_land_surface,
/area/ruin/unpowered/drake)
"VV" = (
/obj/structure/stone_tile,
/obj/structure/stone_tile/block/cracked{
	dir = 1
	},
/obj/effect/mapping_helpers/no_lava,
/turf/simulated/floor/plating/asteroid/basalt/lava_land_surface,
/area/ruin/unpowered/drake)
"WA" = (
/obj/structure/bones/skull,
/obj/effect/mapping_helpers/no_lava,
/obj/effect/mapping_helpers/no_lava,
/turf/simulated/floor/plating/asteroid/basalt/lava_land_surface,
/area/ruin/unpowered/drake)
"Yv" = (
/obj/structure/stone_tile/block/cracked,
/obj/structure/stone_tile/cracked{
	dir = 4
	},
/obj/structure/stone_tile{
	dir = 1
	},
/turf/simulated/floor/plating/lava/smooth/lava_land_surface,
/area/lavaland/surface/outdoors)
"ZL" = (
/obj/structure/stone_tile/cracked{
	dir = 1
	},
/obj/effect/mapping_helpers/no_lava,
/turf/simulated/floor/plating/asteroid/basalt/lava_land_surface,
/area/ruin/unpowered/drake)

(1,1,1) = {"
xB
xB
xB
xB
xB
bB
bB
xB
xB
uO
xB
pW
xB
xB
xB
xB
xB
bB
bB
bB
bB
xB
xB
xB
xB
"}
(2,1,1) = {"
uO
uO
xB
xB
bB
bB
bB
bB
bB
bB
xB
xB
kN
Ud
bB
bB
bB
bB
bB
bB
bB
xB
xB
xB
xB
"}
(3,1,1) = {"
xB
xB
bB
bB
bB
bB
gY
bB
bB
bB
bB
oM
DG
uQ
bB
bB
bB
gY
bB
gY
bB
bB
bB
xB
xB
"}
(4,1,1) = {"
xB
xB
bB
bB
bB
bB
gY
gY
gY
bB
bB
bB
Yv
dv
bB
bB
gY
gY
gY
gY
bB
bB
bB
bB
xB
"}
(5,1,1) = {"
xB
bB
bB
bB
bB
gY
QD
QD
gY
gY
bB
Iq
DY
SW
bB
gY
RQ
QD
gY
Os
gY
bB
bB
bB
xB
"}
(6,1,1) = {"
bB
bB
bB
bB
gY
gY
aS
gY
eu
gY
gY
PI
ZL
TZ
gY
gY
QD
gY
tw
fF
aS
gY
bB
bB
xB
"}
(7,1,1) = {"
xB
bB
bB
bB
gY
gY
fF
gY
gY
gY
aS
QD
Bv
ja
gY
sH
gY
gY
gY
gY
gY
gY
bB
bB
xB
"}
(8,1,1) = {"
xB
xB
bB
bB
gY
gY
gY
gY
QD
gY
Oe
ZL
gY
gY
gY
gY
Oe
Du
gY
gY
QD
bB
bB
bB
xB
"}
(9,1,1) = {"
xB
xB
bB
bB
bB
gY
QD
Du
gY
fF
gY
gY
rV
ZL
CM
QD
gY
eu
gY
gY
QD
gY
bB
bB
xB
"}
(10,1,1) = {"
xB
bB
bB
bB
QD
QD
gY
eu
ed
gY
RQ
qj
Du
rV
gY
gY
tw
gY
RQ
QD
gY
gY
bB
bB
xB
"}
(11,1,1) = {"
xB
bB
bB
QD
QD
gY
gY
gY
gY
WA
ed
gY
qj
gY
gY
qj
tw
gY
gY
gY
gY
gY
bB
bB
xB
"}
(12,1,1) = {"
bB
bB
bB
QD
Oe
kh
xU
de
gY
gY
gY
qj
qj
qj
qj
gY
CJ
gY
gY
gY
gY
bB
bB
xB
xB
"}
(13,1,1) = {"
bB
bB
bB
QD
qt
tw
fw
gY
gY
PJ
RQ
qj
mm
qj
ey
ZL
gY
aS
Vs
Os
gY
bB
bB
xB
xB
"}
(14,1,1) = {"
bB
bB
bB
QD
QD
gY
gY
gY
ja
gY
qj
qj
qj
qj
gY
gY
rV
gY
gY
gY
bB
bB
bB
bB
bB
"}
(15,1,1) = {"
bB
bB
bB
bB
QD
QD
gY
gY
gY
xU
gY
qj
gY
qj
CM
eu
xU
gY
gY
gY
hx
bB
bB
bB
xB
"}
(16,1,1) = {"
xB
bB
bB
bB
bB
gY
gY
QD
ZL
gY
qj
CM
gY
gY
qj
ZL
gY
Vs
gY
Du
bB
bB
bB
bB
xB
"}
(17,1,1) = {"
xB
bB
bB
bB
gY
gY
gY
gY
Lf
rV
RQ
gY
xU
xU
Du
gY
gY
gY
QD
gY
gY
bB
bB
xB
xB
"}
(18,1,1) = {"
xB
xB
bB
bB
gY
gY
aS
aj
QD
gY
gY
gY
ZL
gY
xU
gY
pH
gY
gY
gY
gY
bB
bB
bB
xB
"}
(19,1,1) = {"
xB
xB
bB
bB
bB
gY
gY
gY
gY
tw
Oe
aj
QD
gY
gY
gY
gY
gY
gY
gY
LB
gY
bB
bB
xB
"}
(20,1,1) = {"
xB
xB
bB
bB
gY
QD
gY
gY
gY
gY
fF
VV
gY
rV
gY
Oe
bV
gY
eu
gY
Rs
gY
bB
bB
xB
"}
(21,1,1) = {"
xB
bB
bB
bB
gY
QD
gY
eu
gY
gY
aj
Jl
rV
ja
gY
gY
gY
gY
gY
ZL
QD
gY
bB
bB
xB
"}
(22,1,1) = {"
xB
xB
bB
bB
bB
gY
QD
gY
gY
gY
hQ
NI
lW
gY
gY
gY
QD
gY
gY
gY
gY
bB
bB
xB
xB
"}
(23,1,1) = {"
xB
xB
bB
bB
bB
bB
bB
bB
gY
bB
bB
dw
wT
bB
gY
bB
bB
QD
gY
bB
gY
bB
bB
xB
xB
"}
(24,1,1) = {"
xB
xB
xB
xB
bB
bB
bB
bB
bB
bB
Jb
tj
dv
bB
bB
bB
bB
bB
bB
xB
bB
bB
xB
xB
xB
"}
(25,1,1) = {"
xB
xB
xB
xB
xB
xB
xB
bB
bB
bB
xB
kN
Ud
xB
xB
bB
xB
bB
bB
bB
bB
bB
xB
xB
xB
"}
