//MAP CONVERTED BY dmm2tgm.py THIS HEADER COMMENT PREVENTS RECONVERSION, DO NOT REMOVE
"a" = (
/turf/template_noop,
/area/template_noop)
"b" = (
/obj/structure/sign/poster/official/random{
	dir = 8;
	pixel_x = -32
	},
/obj/structure/dresser,
/turf/simulated/floor/indestructible/carpet,
/area/template_noop)
"c" = (
/turf/simulated/floor/indestructible/carpet,
/area/template_noop)
"d" = (
/obj/structure/bed,
/obj/item/bedsheet,
/obj/machinery/light{
	dir = 4
	},
/turf/simulated/floor/indestructible/carpet,
/area/template_noop)
"e" = (
/obj/machinery/light{
	dir = 8
	},
/turf/simulated/floor/indestructible/carpet,
/area/template_noop)
"f" = (
/obj/structure/bed,
/obj/item/bedsheet,
/obj/item/toy/plushie/deer,
/turf/simulated/floor/indestructible/carpet,
/area/template_noop)
"g" = (
/obj/effect/visual_portal{
	id = "snowland_room";
	frustrum = 1
	},
/obj/effect/decal/snow/sand/surround{
	dir = 1
	},
/turf/simulated/floor/indestructible/snow,
/area/template_noop)
"h" = (
/obj/effect/decal/snow/sand/edge,
/turf/simulated/floor/indestructible/carpet,
/area/template_noop)
"l" = (
/turf/simulated/wall/indestructible/fakeglass,
/area/template_noop)
"J" = (
/turf/simulated/floor/indestructible/view_portal/dense,
/area/template_noop)
"U" = (
/turf/simulated/wall/indestructible/invisible/view_portal,
/area/template_noop)

(1,1,1) = {"
a
a
a
a
a
a
a
"}
(2,1,1) = {"
a
b
e
l
U
U
a
"}
(3,1,1) = {"
a
c
c
l
J
U
a
"}
(4,1,1) = {"
a
c
h
g
J
U
a
"}
(5,1,1) = {"
a
c
c
l
J
U
a
"}
(6,1,1) = {"
a
f
d
l
U
U
a
"}
(7,1,1) = {"
a
a
a
a
a
a
a
"}
