//MAP CONVERTED BY dmm2tgm.py THIS HEADER COMMENT PREVENTS RECONVERSION, DO NOT REMOVE
"a" = (
/turf/template_noop,
/area/template_noop)
"b" = (
/obj/structure/sign/poster/official/random{
	dir = 8;
	pixel_x = -32
	},
/turf/simulated/floor/indestructible/carpet,
/area/template_noop)
"c" = (
/turf/simulated/floor/indestructible/carpet,
/area/template_noop)
"d" = (
/obj/structure/dresser,
/turf/simulated/floor/indestructible/carpet,
/area/template_noop)
"e" = (
/obj/machinery/light{
	dir = 8
	},
/turf/simulated/floor/indestructible/carpet,
/area/template_noop)
"f" = (
/obj/structure/bed,
/obj/item/bedsheet,
/obj/item/toy/plushie/deer,
/turf/simulated/floor/indestructible/carpet,
/area/template_noop)
"g" = (
/obj/effect/decal/snow/sand/edge,
/obj/effect/view_portal{
	id = "snowland_room"
	},
/turf/simulated/floor/indestructible/carpet,
/area/template_noop)
"h" = (
/obj/structure/bed,
/obj/item/bedsheet,
/turf/simulated/floor/indestructible/carpet,
/area/template_noop)
"k" = (
/obj/effect/view_portal/visual{
	dist = 6;
	frustrum = 1;
	id = "snowland";
	radius = 2
	},
/turf/simulated/floor/indestructible/snow,
/area/template_noop)
"l" = (
/turf/simulated/wall/indestructible/fakeglass,
/area/template_noop)
"U" = (
/turf/simulated/wall/indestructible/invisible/view_portal,
/area/template_noop)

(1,1,1) = {"
a
a
a
a
a
a
a
"}
(2,1,1) = {"
a
b
e
c
l
U
a
"}
(3,1,1) = {"
a
c
c
c
l
U
a
"}
(4,1,1) = {"
a
c
c
g
k
U
a
"}
(5,1,1) = {"
a
c
c
c
l
U
a
"}
(6,1,1) = {"
a
d
f
h
l
U
a
"}
(7,1,1) = {"
a
a
a
a
a
a
a
"}
