"ac" = (/obj/structure/stone_tile,/obj/structure/stone_tile{dir = 4},/obj/structure/stone_tile{dir = 1},/obj/structure/stone_tile{dir = 8},/obj/structure/table_frame/brass,/turf/simulated/floor/indestructible/boss,/area/mine/necropolis)
"ao" = (/obj/structure/stone_tile/block/cracked{dir = 4},/obj/structure/stone_tile/cracked{dir = 8},/obj/structure/stone_tile{dir = 4},/obj/structure/chair/brass{dir = 1},/turf/simulated/floor/indestructible/boss,/area/mine/necropolis)
"aE" = (/obj/structure/stone_tile/block/cracked{dir = 4},/obj/structure/stone_tile/block{dir = 8},/obj/structure/table/reinforced/brass,/obj/item/multitool/brass,/turf/simulated/floor/indestructible/boss,/area/mine/necropolis)
"aJ" = (/obj/structure/stone_tile/block/cracked{dir = 8},/obj/structure/stone_tile{dir = 1},/obj/structure/stone_tile,/obj/structure/chair/brass{dir = 4},/turf/simulated/floor/indestructible/boss,/area/mine/necropolis)
"aQ" = (/obj/structure/stone_tile/cracked{dir = 4},/obj/structure/stone_tile{dir = 1},/obj/structure/stone_tile,/obj/structure/stone_tile{dir = 8},/obj/structure/table/reinforced/brass,/obj/item/weldingtool/experimental/brass,/turf/simulated/floor/indestructible/boss,/area/mine/necropolis)
"aS" = (/obj/structure/stone_tile/cracked{dir = 1},/obj/structure/stone_tile{dir = 4},/obj/structure/stone_tile,/obj/structure/stone_tile{dir = 8},/obj/structure/bookcase,/turf/simulated/floor/indestructible/boss,/area/mine/necropolis)
"bK" = (/obj/structure/stone_tile/block/cracked{dir = 4},/obj/structure/stone_tile/block{dir = 8},/obj/structure/table/reinforced/brass,/obj/item/wirecutters/brass,/turf/simulated/floor/indestructible/boss,/area/mine/necropolis)
"bP" = (/obj/structure/stone_tile/block/cracked{dir = 4},/obj/structure/stone_tile/cracked{dir = 8},/obj/structure/stone_tile{dir = 4},/obj/structure/table/reinforced/brass,/obj/item/storage/toolbox/brass/prefilled,/turf/simulated/floor/indestructible/boss,/area/mine/necropolis)
"cl" = (/obj/structure/stone_tile/block/cracked{dir = 4},/obj/structure/stone_tile/block{dir = 8},/mob/living/simple_animal/hostile/asteroid/goliath/beast/ancient,/turf/simulated/floor/indestructible/boss,/area/mine/necropolis)
"cF" = (/obj/structure/stone_tile/block/cracked{dir = 4},/obj/structure/stone_tile/block{dir = 8},/obj/structure/table/reinforced/brass,/obj/item/weldingtool/experimental/brass,/turf/simulated/floor/indestructible/boss,/area/mine/necropolis)
"cH" = (/obj/structure/stone_tile,/obj/structure/stone_tile{dir = 8},/obj/structure/stone_tile/block/cracked{dir = 1},/obj/structure/chair/brass{dir = 4},/mob/living/simple_animal/hostile/asteroid/goliath/beast/ancient,/turf/simulated/floor/indestructible/boss,/area/mine/necropolis)
"cJ" = (/obj/structure/stone_tile/cracked{dir = 4},/obj/structure/stone_tile{dir = 1},/obj/structure/stone_tile,/obj/structure/stone_tile{dir = 8},/obj/structure/chair/brass{dir = 4},/mob/living/simple_animal/hostile/asteroid/goliath/beast/ancient,/turf/simulated/floor/indestructible/boss,/area/mine/necropolis)
"cR" = (/obj/structure/stone_tile/cracked{dir = 4},/obj/structure/stone_tile{dir = 1},/obj/structure/stone_tile,/obj/structure/stone_tile{dir = 8},/obj/structure/table_frame/brass,/turf/simulated/floor/indestructible/boss,/area/mine/necropolis)
"cU" = (/obj/structure/stone_tile/block/cracked{dir = 4},/obj/structure/stone_tile/cracked{dir = 8},/obj/structure/stone_tile{dir = 4},/mob/living/simple_animal/hostile/asteroid/goliath/beast/ancient,/turf/simulated/floor/indestructible/boss,/area/mine/necropolis)
"dn" = (/obj/structure/stone_tile/block/cracked{dir = 4},/obj/structure/stone_tile/block{dir = 8},/obj/structure/chair/brass,/turf/simulated/floor/indestructible/boss,/area/mine/necropolis)
"dB" = (/obj/structure/stone_tile/cracked{dir = 1},/obj/structure/stone_tile{dir = 4},/obj/structure/stone_tile,/obj/structure/stone_tile{dir = 8},/obj/structure/stone_tile/center/cracked,/turf/simulated/floor/indestructible/boss,/area/mine/necropolis)
"eM" = (/obj/structure/stone_tile/slab/cracked,/obj/structure/table/reinforced/brass,/obj/item/weldingtool/experimental/brass,/turf/simulated/floor/indestructible/boss,/area/mine/necropolis)
"fa" = (/obj/structure/stone_tile/block/cracked{dir = 8},/obj/structure/stone_tile{dir = 1},/obj/structure/stone_tile,/obj/structure/stone_tile/slab/cracked{dir = 4},/turf/simulated/floor/indestructible/boss,/area/mine/necropolis)
"gb" = (/obj/structure/stone_tile/cracked{dir = 1},/obj/structure/stone_tile{dir = 4},/obj/structure/stone_tile,/obj/structure/stone_tile{dir = 8},/mob/living/simple_animal/hostile/asteroid/basilisk/watcher/magmawing,/turf/simulated/floor/indestructible/boss,/area/mine/necropolis)
"gd" = (/obj/structure/stone_tile/cracked{dir = 4},/obj/structure/stone_tile{dir = 1},/obj/structure/stone_tile,/obj/structure/stone_tile{dir = 8},/obj/structure/stone_tile/center,/obj/structure/table/reinforced/brass,/obj/item/wirecutters/brass,/turf/simulated/floor/indestructible/boss,/area/mine/necropolis)
"gV" = (/obj/structure/stone_tile/block/cracked{dir = 4},/obj/structure/stone_tile/block{dir = 8},/obj/structure/table/reinforced/brass,/obj/item/storage/toolbox/brass/prefilled,/turf/simulated/floor/indestructible/boss,/area/mine/necropolis)
"hr" = (/obj/structure/stone_tile/cracked{dir = 4},/obj/structure/stone_tile{dir = 1},/obj/structure/stone_tile,/obj/structure/stone_tile{dir = 8},/obj/structure/stone_tile/center,/obj/structure/bookcase,/turf/simulated/floor/indestructible/boss,/area/mine/necropolis)
"hx" = (/obj/structure/stone_tile,/obj/structure/stone_tile{dir = 8},/obj/structure/stone_tile/block/cracked{dir = 1},/obj/structure/table/reinforced/brass,/obj/item/wirecutters/brass,/turf/simulated/floor/indestructible/boss,/area/mine/necropolis)
"il" = (/turf/simulated/wall/indestructible/boss,/area/template_noop)
"jV" = (/obj/structure/stone_tile/slab/cracked,/obj/structure/bookcase,/turf/simulated/floor/indestructible/boss,/area/mine/necropolis)
"kt" = (/turf/simulated/floor/plating/asteroid/basalt/lava_land_surface,/area/template_noop)
"lm" = (/obj/structure/stone_tile,/obj/structure/stone_tile{dir = 8},/obj/structure/stone_tile/block/cracked{dir = 1},/obj/structure/chair/brass{dir = 8},/turf/simulated/floor/indestructible/boss,/area/mine/necropolis)
"lz" = (/obj/structure/stone_tile/cracked{dir = 1},/obj/structure/stone_tile{dir = 4},/obj/structure/stone_tile,/obj/structure/stone_tile{dir = 8},/obj/structure/table/reinforced/brass,/obj/item/weldingtool/experimental/brass,/turf/simulated/floor/indestructible/boss,/area/mine/necropolis)
"nr" = (/obj/structure/stone_tile/block/cracked{dir = 4},/obj/structure/stone_tile/block{dir = 8},/mob/living/simple_animal/hostile/asteroid/hivelord/legion,/turf/simulated/floor/indestructible/boss,/area/mine/necropolis)
"nG" = (/obj/structure/stone_tile/cracked{dir = 4},/obj/structure/stone_tile{dir = 1},/obj/structure/stone_tile,/obj/structure/stone_tile{dir = 8},/obj/structure/table/reinforced/brass,/obj/item/clockwork/clockgolem_remains,/turf/simulated/floor/indestructible/boss,/area/mine/necropolis)
"ph" = (/obj/structure/stone_tile/cracked{dir = 4},/obj/structure/stone_tile{dir = 1},/obj/structure/stone_tile,/obj/structure/stone_tile{dir = 8},/obj/structure/stone_tile/center,/turf/simulated/floor/indestructible/boss,/area/mine/necropolis)
"pF" = (/obj/structure/stone_tile/block/cracked{dir = 4},/obj/structure/stone_tile/block{dir = 8},/obj/structure/chair/brass{dir = 1},/turf/simulated/floor/indestructible/boss,/area/mine/necropolis)
"pN" = (/obj/structure/stone_tile/cracked{dir = 4},/obj/structure/stone_tile{dir = 1},/obj/structure/stone_tile,/obj/structure/stone_tile{dir = 8},/obj/structure/bookcase,/turf/simulated/floor/indestructible/boss,/area/mine/necropolis)
"rF" = (/obj/structure/stone_tile/cracked{dir = 1},/obj/structure/stone_tile{dir = 4},/obj/structure/stone_tile,/obj/structure/stone_tile{dir = 8},/obj/structure/chair/brass{dir = 4},/turf/simulated/floor/indestructible/boss,/area/mine/necropolis)
"sd" = (/obj/structure/stone_tile/slab/cracked,/obj/item/clockwork/clockgolem_remains,/mob/living/simple_animal/hostile/asteroid/goliath/beast/ancient,/turf/simulated/floor/indestructible/boss,/area/mine/necropolis)
"sg" = (/obj/structure/stone_tile/cracked{dir = 4},/obj/structure/stone_tile{dir = 1},/obj/structure/stone_tile,/obj/structure/stone_tile{dir = 8},/obj/structure/chair/brass{dir = 4},/turf/simulated/floor/indestructible/boss,/area/mine/necropolis)
"st" = (/obj/structure/stone_tile/surrounding,/obj/structure/stone_tile/center/cracked,/obj/structure/chair/brass{dir = 4},/mob/living/simple_animal/hostile/big_legion,/turf/simulated/floor/indestructible/boss,/area/mine/necropolis)
"tt" = (/obj/structure/stone_tile/slab/cracked,/obj/item/clockwork/clockgolem_remains,/turf/simulated/floor/indestructible/boss,/area/mine/necropolis)
"tx" = (/obj/structure/stone_tile/cracked{dir = 4},/obj/structure/stone_tile{dir = 1},/obj/structure/stone_tile,/obj/structure/stone_tile{dir = 8},/obj/structure/table/reinforced/brass,/obj/item/multitool/brass,/turf/simulated/floor/indestructible/boss,/area/mine/necropolis)
"tz" = (/obj/structure/stone_tile/block/cracked{dir = 4},/obj/structure/stone_tile/cracked{dir = 8},/obj/structure/stone_tile{dir = 4},/mob/living/simple_animal/hostile/asteroid/hivelord/legion,/turf/simulated/floor/indestructible/boss,/area/mine/necropolis)
"up" = (/obj/structure/stone_tile/block/cracked{dir = 4},/obj/structure/stone_tile/block{dir = 8},/mob/living/simple_animal/hostile/big_legion,/turf/simulated/floor/indestructible/boss,/area/mine/necropolis)
"uw" = (/obj/structure/stone_tile/surrounding,/obj/structure/stone_tile/center/cracked,/obj/structure/chair/brass{dir = 4},/turf/simulated/floor/indestructible/boss,/area/mine/necropolis)
"xc" = (/obj/structure/stone_tile/block/cracked{dir = 4},/obj/structure/stone_tile/block{dir = 8},/obj/item/clockwork/clockgolem_remains,/turf/simulated/floor/indestructible/boss,/area/mine/necropolis)
"xU" = (/obj/structure/stone_tile/block/cracked{dir = 4},/obj/structure/stone_tile/cracked{dir = 8},/obj/structure/stone_tile{dir = 4},/obj/structure/window/reinforced/clockwork{dir = 1; move_resist = 45000},/obj/structure/window/reinforced/clockwork{dir = 4; move_resist = 45000},/obj/structure/closet/crate/necropolis/tendril,/turf/simulated/floor/indestructible/boss,/area/mine/necropolis)
"zJ" = (/obj/structure/stone_tile,/obj/structure/stone_tile{dir = 4},/obj/structure/stone_tile{dir = 1},/obj/structure/stone_tile{dir = 8},/obj/structure/stone_tile/slab/cracked{dir = 8},/turf/simulated/floor/indestructible/boss,/area/mine/necropolis)
"Aj" = (/obj/structure/stone_tile/block/cracked,/turf/simulated/floor/plating/asteroid/basalt/lava_land_surface,/area/template_noop)
"Ap" = (/obj/structure/stone_tile/cracked{dir = 4},/obj/structure/stone_tile{dir = 1},/obj/structure/stone_tile/block,/mob/living/simple_animal/hostile/asteroid/hivelord/legion,/turf/simulated/floor/indestructible/boss,/area/mine/necropolis)
"AL" = (/obj/structure/stone_tile/cracked{dir = 4},/obj/structure/stone_tile{dir = 1},/obj/structure/stone_tile,/obj/structure/stone_tile{dir = 8},/obj/structure/stone_tile/center,/obj/structure/table/reinforced/brass,/obj/item/clockwork/clockgolem_remains,/turf/simulated/floor/indestructible/boss,/area/mine/necropolis)
"Bh" = (/obj/structure/stone_tile,/obj/structure/stone_tile{dir = 8},/obj/structure/stone_tile/block/cracked{dir = 1},/turf/simulated/floor/indestructible/boss,/area/mine/necropolis)
"Bk" = (/obj/structure/stone_tile/cracked{dir = 4},/obj/structure/stone_tile{dir = 1},/obj/structure/stone_tile,/obj/structure/stone_tile{dir = 8},/obj/item/clockwork/clockgolem_remains,/turf/simulated/floor/indestructible/boss,/area/mine/necropolis)
"Br" = (/obj/structure/stone_tile,/obj/structure/stone_tile{dir = 8},/obj/structure/stone_tile/block/cracked{dir = 1},/obj/structure/stone_tile/center,/obj/item/clockwork/clockgolem_remains,/turf/simulated/floor/indestructible/boss,/area/mine/necropolis)
"Bw" = (/obj/structure/stone_tile,/obj/structure/stone_tile{dir = 4},/obj/structure/stone_tile{dir = 1},/obj/structure/stone_tile{dir = 8},/obj/structure/chair/brass,/turf/simulated/floor/indestructible/boss,/area/mine/necropolis)
"BZ" = (/obj/structure/stone_tile/cracked{dir = 4},/obj/structure/stone_tile{dir = 1},/obj/structure/stone_tile,/obj/structure/stone_tile{dir = 8},/obj/structure/table/reinforced/brass,/obj/item/storage/toolbox/brass/prefilled,/turf/simulated/floor/indestructible/boss,/area/mine/necropolis)
"Ck" = (/obj/structure/stone_tile/slab/cracked,/obj/structure/table/reinforced/brass,/obj/item/clockwork/clockgolem_remains,/turf/simulated/floor/indestructible/boss,/area/mine/necropolis)
"DS" = (/obj/structure/stone_tile/cracked{dir = 4},/obj/structure/stone_tile{dir = 1},/obj/structure/stone_tile,/obj/structure/stone_tile{dir = 8},/obj/structure/window/reinforced/clockwork,/obj/structure/window/reinforced/clockwork{dir = 4; move_resist = 45000},/obj/structure/closet/crate/necropolis/tendril,/turf/simulated/floor/indestructible/boss,/area/mine/necropolis)
"DU" = (/obj/structure/stone_tile,/obj/structure/stone_tile{dir = 4},/obj/structure/stone_tile{dir = 1},/obj/structure/stone_tile{dir = 8},/obj/item/clockwork/clockgolem_remains,/mob/living/simple_animal/hostile/asteroid/basilisk/watcher/magmawing,/turf/simulated/floor/indestructible/boss,/area/mine/necropolis)
"Eg" = (/obj/structure/stone_tile,/obj/structure/stone_tile{dir = 8},/obj/structure/stone_tile/block/cracked{dir = 1},/obj/structure/stone_tile/center,/turf/simulated/floor/indestructible/boss,/area/mine/necropolis)
"Fu" = (/obj/structure/stone_tile/surrounding,/obj/structure/stone_tile/center/cracked,/obj/structure/table_frame/brass,/turf/simulated/floor/indestructible/boss,/area/mine/necropolis)
"FD" = (/obj/structure/stone_tile,/obj/structure/stone_tile{dir = 4},/obj/structure/stone_tile{dir = 1},/obj/structure/stone_tile{dir = 8},/obj/item/clockwork/clockgolem_remains,/turf/simulated/floor/indestructible/boss,/area/mine/necropolis)
"FZ" = (/obj/structure/stone_tile,/obj/structure/stone_tile{dir = 8},/obj/structure/stone_tile/block/cracked{dir = 1},/obj/structure/table/reinforced/brass,/obj/item/clockwork/clockgolem_remains,/turf/simulated/floor/indestructible/boss,/area/mine/necropolis)
"GE" = (/obj/structure/stone_tile/cracked{dir = 4},/obj/structure/stone_tile{dir = 1},/obj/structure/stone_tile,/obj/structure/stone_tile{dir = 8},/obj/structure/stone_tile/center/cracked,/turf/simulated/floor/indestructible/boss,/area/mine/necropolis)
"GM" = (/obj/structure/stone_tile/cracked{dir = 1},/obj/structure/stone_tile{dir = 4},/obj/structure/stone_tile,/obj/structure/stone_tile{dir = 8},/obj/item/clockwork/clockgolem_remains,/turf/simulated/floor/indestructible/boss,/area/mine/necropolis)
"GY" = (/obj/structure/stone_tile/cracked{dir = 4},/obj/structure/stone_tile{dir = 1},/obj/structure/stone_tile,/obj/structure/stone_tile{dir = 8},/mob/living/simple_animal/hostile/asteroid/hivelord/legion,/turf/simulated/floor/indestructible/boss,/area/mine/necropolis)
"Hc" = (/obj/structure/stone_tile/cracked{dir = 4},/obj/structure/stone_tile{dir = 1},/obj/structure/stone_tile,/obj/structure/stone_tile{dir = 8},/obj/structure/stone_tile/slab/cracked{dir = 4},/turf/simulated/floor/indestructible/boss,/area/mine/necropolis)
"Hv" = (/obj/structure/stone_tile/cracked{dir = 4},/obj/structure/stone_tile{dir = 1},/obj/structure/stone_tile,/obj/structure/stone_tile{dir = 8},/obj/structure/table/reinforced/brass,/obj/item/wrench/brass,/turf/simulated/floor/indestructible/boss,/area/mine/necropolis)
"Ik" = (/obj/structure/stone_tile,/obj/structure/stone_tile{dir = 4},/obj/structure/stone_tile{dir = 1},/obj/structure/stone_tile{dir = 8},/turf/simulated/floor/indestructible/boss,/area/mine/necropolis)
"Ip" = (/obj/structure/stone_tile/block/cracked{dir = 4},/obj/structure/stone_tile/cracked{dir = 8},/obj/structure/stone_tile{dir = 4},/obj/structure/table_frame/brass,/turf/simulated/floor/indestructible/boss,/area/mine/necropolis)
"It" = (/turf/template_noop,/area/template_noop)
"IP" = (/obj/structure/stone_tile/slab/cracked,/turf/simulated/floor/indestructible/boss,/area/mine/necropolis)
"IX" = (/obj/structure/stone_tile/slab/cracked,/mob/living/simple_animal/hostile/asteroid/hivelord/legion,/turf/simulated/floor/indestructible/boss,/area/mine/necropolis)
"Ja" = (/obj/structure/stone_tile/block/cracked{dir = 4},/obj/structure/stone_tile/cracked{dir = 8},/obj/structure/stone_tile{dir = 4},/turf/simulated/floor/indestructible/boss,/area/mine/necropolis)
"KQ" = (/obj/structure/stone_tile/surrounding,/obj/structure/stone_tile/center,/turf/simulated/floor/indestructible/boss,/area/mine/necropolis)
"KY" = (/turf/simulated/mineral/random/high_chance/volcanic,/area/template_noop)
"Le" = (/obj/structure/stone_tile{dir = 4},/obj/structure/stone_tile{dir = 1},/obj/structure/stone_tile/block,/obj/structure/table/reinforced/brass,/obj/item/clockwork/clockgolem_remains,/turf/simulated/floor/indestructible/boss,/area/mine/necropolis)
"Na" = (/obj/structure/stone_tile/cracked{dir = 4},/obj/structure/stone_tile{dir = 1},/obj/structure/stone_tile,/obj/structure/stone_tile{dir = 8},/obj/structure/stone_tile/slab/cracked{dir = 8},/obj/item/clockwork/clockgolem_remains,/turf/simulated/floor/indestructible/boss,/area/mine/necropolis)
"Od" = (/obj/structure/stone_tile/cracked{dir = 4},/obj/structure/stone_tile{dir = 1},/obj/structure/stone_tile,/obj/structure/stone_tile{dir = 8},/obj/structure/table/reinforced/brass,/turf/simulated/floor/indestructible/boss,/area/mine/necropolis)
"Ok" = (/obj/structure/stone_tile/surrounding,/obj/structure/stone_tile/center/cracked,/turf/simulated/floor/indestructible/boss,/area/mine/necropolis)
"Op" = (/obj/structure/stone_tile,/obj/structure/stone_tile{dir = 8},/obj/structure/stone_tile/block/cracked{dir = 1},/obj/structure/table/reinforced/brass,/turf/simulated/floor/indestructible/boss,/area/mine/necropolis)
"Or" = (/obj/structure/clockwork/wall_gear,/turf/simulated/wall/indestructible/boss,/area/mine/necropolis)
"OH" = (/obj/structure/stone_tile/slab/cracked,/obj/structure/table/reinforced/brass,/obj/item/multitool/brass,/turf/simulated/floor/indestructible/boss,/area/mine/necropolis)
"OM" = (/obj/structure/stone_tile/slab/cracked,/obj/structure/table/reinforced/brass,/turf/simulated/floor/indestructible/boss,/area/mine/necropolis)
"OW" = (/obj/structure/stone_tile/cracked,/turf/simulated/floor/plating/asteroid/basalt/lava_land_surface,/area/template_noop)
"Ph" = (/obj/structure/stone_tile/cracked{dir = 4},/obj/structure/stone_tile{dir = 1},/obj/structure/stone_tile,/obj/structure/stone_tile{dir = 8},/obj/structure/stone_tile/center,/mob/living/simple_animal/hostile/asteroid/basilisk/watcher/magmawing,/turf/simulated/floor/indestructible/boss,/area/mine/necropolis)
"Pu" = (/obj/structure/stone_tile/cracked{dir = 1},/obj/structure/stone_tile{dir = 4},/obj/structure/stone_tile/block,/turf/simulated/floor/indestructible/boss,/area/mine/necropolis)
"Qe" = (/obj/structure/stone_tile/surrounding,/obj/structure/stone_tile/center/cracked,/mob/living/simple_animal/hostile/asteroid/goliath/beast/ancient,/turf/simulated/floor/indestructible/boss,/area/mine/necropolis)
"Rz" = (/obj/structure/stone_tile/cracked{dir = 4},/obj/structure/stone_tile{dir = 1},/obj/structure/stone_tile,/obj/structure/stone_tile{dir = 8},/obj/structure/chair/brass{dir = 1},/turf/simulated/floor/indestructible/boss,/area/mine/necropolis)
"RA" = (/obj/structure/stone_tile/block/cracked{dir = 4},/obj/structure/stone_tile/block{dir = 8},/turf/simulated/floor/indestructible/boss,/area/mine/necropolis)
"RL" = (/obj/structure/stone_tile/slab/cracked,/obj/structure/window/reinforced/clockwork{dir = 4; move_resist = 45000},/obj/structure/window/reinforced/clockwork{dir = 1; move_resist = 45000},/obj/structure/closet/crate/necropolis/tendril,/turf/simulated/floor/indestructible/boss,/area/mine/necropolis)
"Sc" = (/obj/structure/stone_tile/cracked{dir = 1},/obj/structure/stone_tile{dir = 4},/obj/structure/stone_tile,/obj/structure/stone_tile{dir = 8},/obj/structure/table/reinforced/brass,/turf/simulated/floor/indestructible/boss,/area/mine/necropolis)
"SV" = (/obj/structure/stone_tile/cracked{dir = 1},/obj/structure/stone_tile{dir = 4},/obj/structure/stone_tile/block,/obj/item/clockwork/clockgolem_remains,/turf/simulated/floor/indestructible/boss,/area/mine/necropolis)
"Te" = (/obj/structure/stone_tile/cracked{dir = 1},/obj/structure/stone_tile{dir = 4},/obj/structure/stone_tile,/obj/structure/stone_tile{dir = 8},/turf/simulated/floor/indestructible/boss,/area/mine/necropolis)
"TB" = (/obj/structure/stone_tile,/obj/structure/stone_tile{dir = 4},/obj/structure/stone_tile{dir = 1},/obj/structure/stone_tile{dir = 8},/mob/living/simple_animal/hostile/asteroid/basilisk/watcher/magmawing,/turf/simulated/floor/indestructible/boss,/area/mine/necropolis)
"Vh" = (/turf/simulated/wall/indestructible/boss,/area/mine/necropolis)
"Wz" = (/obj/structure/stone_tile,/obj/structure/stone_tile{dir = 8},/obj/structure/stone_tile/block/cracked{dir = 1},/obj/item/clockwork/clockgolem_remains,/turf/simulated/floor/indestructible/boss,/area/mine/necropolis)
"WQ" = (/obj/structure/stone_tile/cracked{dir = 4},/obj/structure/stone_tile{dir = 1},/obj/structure/stone_tile,/obj/structure/stone_tile{dir = 8},/turf/simulated/floor/indestructible/boss,/area/mine/necropolis)
"XA" = (/obj/structure/stone_tile,/obj/structure/stone_tile{dir = 8},/obj/structure/stone_tile/block/cracked{dir = 1},/obj/structure/chair/brass{dir = 4},/turf/simulated/floor/indestructible/boss,/area/mine/necropolis)
"XN" = (/obj/structure/stone_tile/block/cracked{dir = 4},/obj/structure/stone_tile/block{dir = 8},/obj/structure/table/reinforced/brass,/turf/simulated/floor/indestructible/boss,/area/mine/necropolis)
"Yn" = (/obj/structure/stone_tile/cracked{dir = 4},/obj/structure/stone_tile{dir = 1},/obj/structure/stone_tile/block,/turf/simulated/floor/indestructible/boss,/area/mine/necropolis)
"YF" = (/obj/structure/stone_tile/block/cracked{dir = 4},/obj/structure/stone_tile/block{dir = 8},/obj/structure/table_frame/brass,/turf/simulated/floor/indestructible/boss,/area/mine/necropolis)
"Zz" = (/obj/structure/stone_tile/slab/cracked,/obj/structure/stone_tile/center/cracked,/turf/simulated/floor/indestructible/boss,/area/mine/necropolis)
"ZC" = (/obj/structure/stone_tile/block/cracked{dir = 4},/obj/structure/stone_tile/block{dir = 8},/obj/structure/stone_tile/slab/cracked{dir = 4},/turf/simulated/floor/indestructible/boss,/area/mine/necropolis)

(1,1,1) = {"
ItItItItItItItItItItItItItItItItItItItItItItItItItItItItItItItItIt
ItVhVhVhVhVhVhVhVhVhVhVhVhVhVhVhVhVhVhVhVhVhVhVhVhVhVhVhVhVhVhVhIt
ItVhVhVhVhVhVhVhVhVhVhVhVhVhVhVhVhVhVhVhVhVhVhVhVhVhVhVhVhVhVhVhIt
ItVhVhVhVhVhVhVhVhVhVhVhVhVhVhOraShrjVOrVhVhOrVhVhVhVhVhVhVhVhVhIt
ItVhVhVhVhVhVhVhVhVhJaWQTettJaRAPhJaWQxcIPJaIkVhVhVhVhVhVhVhVhVhIt
ItVhVhVhVhVhVhVhOrIPupXNphWQYFIPJaRABwEgWQdnIPWQVhOrgVALOdbKOrVhIt
ItVhVhVhVhOrOkBhApSVXAOdWQrFhxBkclTeOMaQFuFZJaRAVhnrIPJaQeBhttVhIt
ItVhVhVhVhDSIPbPYFOkWQlzRAOkOdTeBhApWQTeYngbxcIPOrEgWQRABkEgWQVhIt
ItVhVhVhVhTeTecHeMJaRAphIPJaRAKQWQGMRAphRAGEEgHcIPWQuwOpTeWQOkVhIt
ItVhVhVhVhphOkcJOdRAIPJaGEnrZzJaZCWQPuBhBktzWQOkWQIPaoXNphJafaOrIt
ItVhVhVhVhxUtzaELeBrWQXNDUEgtxRAttRAKQWQdBRAOkRAOrWQYFOHtzBhGYRAIt
ItVhVhVhVhOrRAIPIPWQstOpIPsgacEgWQIXIpYFgdOpJaIPVhzJEgWQnrNaIPOrIt
ItVhVhVhVhVhVhVhOrIXEgcRRAEgCkWQKQWQpFIPcURzRAWQVhsdWQKQWQdnRAVhIt
ItVhVhVhVhVhVhVhVhVhWQOkBhWQOkWzTBIkEgWQRAFDEgVhVhVhnrVhnGaEYFVhIt
ItililililililililililililililOrjVjVpNOrVhVhOrVhIPOkBhVhililililIt
ItilililililililililililililililililililHvJaWQRAWQIXIkWzililililIt
ItililKYKYKYOWktktktktktKYKYililililililSclmOkTBBhBZOrilililItItIt
ItililKYAjktktktktktktktktKYKYilililililOrRLBhBkaJcFililililItItIt
ItOWktktktktktktktktktktktktKYilililililililililililililililItItIt
ItItItItItItItItItItItItItItItItItItItItItItItItItItItItItItItItIt
"}
