"ab" = (/obj/structure/stone_tile/cracked{dir = 4},/obj/structure/stone_tile{dir = 1},/obj/structure/stone_tile,/obj/structure/stone_tile{dir = 8},/obj/item/clockwork/clockgolem_remains,/turf/simulated/floor/indestructible/boss,/area/mine/necropolis)
"av" = (/obj/structure/stone_tile/slab/cracked,/turf/simulated/floor/indestructible/boss,/area/mine/necropolis)
"bm" = (/obj/structure/stone_tile,/obj/structure/stone_tile{dir = 4},/obj/structure/stone_tile{dir = 1},/obj/structure/stone_tile{dir = 8},/obj/structure/chair/brass{dir = 1},/turf/simulated/floor/indestructible/boss,/area/mine/necropolis)
"bE" = (/obj/structure/stone_tile,/obj/structure/stone_tile{dir = 4},/obj/structure/stone_tile{dir = 1},/obj/structure/stone_tile{dir = 8},/obj/item/clockwork/clockgolem_remains,/turf/simulated/floor/indestructible/boss,/area/mine/necropolis)
"dP" = (/obj/structure/stone_tile/cracked{dir = 1},/obj/structure/stone_tile{dir = 4},/obj/structure/stone_tile,/obj/structure/stone_tile{dir = 8},/obj/structure/bookcase,/turf/simulated/floor/indestructible/boss,/area/mine/necropolis)
"eG" = (/obj/structure/stone_tile/slab/cracked,/mob/living/simple_animal/hostile/asteroid/goliath/beast/ancient,/turf/simulated/floor/indestructible/boss,/area/mine/necropolis)
"eS" = (/obj/structure/stone_tile,/obj/structure/stone_tile{dir = 8},/obj/structure/stone_tile/block/cracked{dir = 1},/obj/structure/table/reinforced/brass,/turf/simulated/floor/indestructible/boss,/area/mine/necropolis)
"il" = (/turf/simulated/wall/indestructible/boss,/area/template_noop)
"io" = (/obj/structure/stone_tile,/obj/structure/stone_tile{dir = 4},/obj/structure/stone_tile{dir = 1},/obj/structure/stone_tile{dir = 8},/obj/structure/table/reinforced/brass,/turf/simulated/floor/indestructible/boss,/area/mine/necropolis)
"iD" = (/obj/structure/stone_tile,/obj/structure/stone_tile{dir = 4},/obj/structure/stone_tile{dir = 1},/obj/structure/stone_tile{dir = 8},/mob/living/simple_animal/hostile/asteroid/goliath/beast/ancient,/turf/simulated/floor/indestructible/boss,/area/mine/necropolis)
"jv" = (/obj/structure/stone_tile,/obj/structure/stone_tile{dir = 8},/obj/structure/stone_tile/block/cracked{dir = 1},/obj/structure/chair/brass{dir = 8},/turf/simulated/floor/indestructible/boss,/area/mine/necropolis)
"kt" = (/turf/simulated/floor/plating/asteroid/basalt/lava_land_surface,/area/template_noop)
"kv" = (/obj/structure/stone_tile,/obj/structure/stone_tile{dir = 4},/obj/structure/stone_tile{dir = 1},/obj/structure/stone_tile{dir = 8},/obj/structure/closet/crate/necropolis,/turf/simulated/floor/indestructible/boss,/area/mine/necropolis)
"lY" = (/obj/structure/stone_tile/slab/cracked,/obj/item/clockwork/clockgolem_remains,/turf/simulated/floor/indestructible/boss,/area/mine/necropolis)
"nq" = (/obj/structure/stone_tile/cracked,/turf/simulated/floor/plating/asteroid/basalt/lava_land_surface,/area/template_noop)
"nB" = (/obj/structure/stone_tile/block/cracked{dir = 8},/obj/structure/stone_tile{dir = 1},/obj/structure/stone_tile,/mob/living/simple_animal/hostile/asteroid/hivelord/legion,/turf/simulated/floor/indestructible/boss,/area/mine/necropolis)
"ow" = (/obj/structure/stone_tile/cracked{dir = 4},/obj/structure/stone_tile{dir = 1},/obj/structure/stone_tile,/obj/structure/stone_tile{dir = 8},/obj/structure/chair/brass,/turf/simulated/floor/indestructible/boss,/area/mine/necropolis)
"pC" = (/obj/structure/stone_tile/block/cracked{dir = 4},/obj/structure/stone_tile/cracked{dir = 8},/obj/structure/stone_tile{dir = 4},/obj/item/clockwork/clockgolem_remains,/turf/simulated/floor/indestructible/boss,/area/mine/necropolis)
"tt" = (/obj/structure/stone_tile/cracked{dir = 1},/obj/structure/stone_tile{dir = 4},/obj/structure/stone_tile,/obj/structure/stone_tile{dir = 8},/obj/structure/table/reinforced/brass,/turf/simulated/floor/indestructible/boss,/area/mine/necropolis)
"uh" = (/obj/structure/stone_tile,/obj/structure/stone_tile{dir = 8},/obj/structure/stone_tile/block/cracked{dir = 1},/obj/structure/bookcase,/turf/simulated/floor/indestructible/boss,/area/mine/necropolis)
"uw" = (/obj/structure/stone_tile/surrounding,/obj/structure/stone_tile/center/cracked,/mob/living/simple_animal/hostile/asteroid/basilisk/watcher/magmawing,/turf/simulated/floor/indestructible/boss,/area/mine/necropolis)
"va" = (/obj/structure/stone_tile/block/cracked{dir = 8},/obj/structure/stone_tile{dir = 1},/obj/structure/stone_tile,/obj/item/clockwork/clockgolem_remains,/turf/simulated/floor/indestructible/boss,/area/mine/necropolis)
"vK" = (/obj/structure/stone_tile/block/cracked{dir = 4},/obj/structure/stone_tile/cracked{dir = 8},/obj/structure/stone_tile{dir = 4},/obj/structure/chair/brass{dir = 8},/turf/simulated/floor/indestructible/boss,/area/mine/necropolis)
"xc" = (/obj/structure/stone_tile/cracked{dir = 4},/obj/structure/stone_tile{dir = 1},/obj/structure/stone_tile,/obj/structure/stone_tile{dir = 8},/obj/structure/table/reinforced/brass,/turf/simulated/floor/indestructible/boss,/area/mine/necropolis)
"zM" = (/obj/structure/stone_tile/surrounding,/obj/structure/stone_tile/center/cracked,/turf/simulated/floor/indestructible/boss,/area/mine/necropolis)
"CR" = (/obj/structure/stone_tile/block/cracked{dir = 4},/obj/structure/stone_tile/block{dir = 8},/obj/item/clockwork/clockgolem_remains,/turf/simulated/floor/indestructible/boss,/area/mine/necropolis)
"Df" = (/obj/structure/stone_tile/surrounding,/obj/structure/stone_tile/center/cracked,/obj/structure/table/reinforced/brass,/turf/simulated/floor/indestructible/boss,/area/mine/necropolis)
"DI" = (/obj/structure/stone_tile/block/cracked{dir = 8},/obj/structure/stone_tile{dir = 1},/obj/structure/stone_tile,/obj/structure/table/reinforced/brass,/obj/item/wirecutters/brass,/turf/simulated/floor/indestructible/boss,/area/mine/necropolis)
"DS" = (/obj/structure/stone_tile,/obj/structure/stone_tile{dir = 8},/obj/structure/stone_tile/block/cracked{dir = 1},/obj/structure/closet/crate/necropolis/tendril,/turf/simulated/floor/indestructible/boss,/area/mine/necropolis)
"DU" = (/obj/structure/stone_tile/cracked{dir = 4},/obj/structure/stone_tile{dir = 1},/obj/structure/stone_tile,/obj/structure/stone_tile{dir = 8},/obj/structure/table/reinforced/brass,/obj/item/wrench/brass,/turf/simulated/floor/indestructible/boss,/area/mine/necropolis)
"Ed" = (/obj/structure/stone_tile/block/cracked{dir = 8},/obj/structure/stone_tile{dir = 1},/obj/structure/stone_tile,/obj/structure/chair/brass{dir = 4},/turf/simulated/floor/indestructible/boss,/area/mine/necropolis)
"GE" = (/obj/structure/stone_tile/block/cracked,/turf/simulated/floor/plating/asteroid/basalt/lava_land_surface,/area/template_noop)
"GI" = (/obj/structure/stone_tile/cracked{dir = 4},/obj/structure/stone_tile{dir = 1},/obj/structure/stone_tile,/obj/structure/stone_tile{dir = 8},/obj/structure/bookcase,/turf/simulated/floor/indestructible/boss,/area/mine/necropolis)
"It" = (/turf/template_noop,/area/template_noop)
"Ji" = (/obj/structure/stone_tile/block/cracked{dir = 4},/obj/structure/stone_tile/block{dir = 8},/obj/structure/table/reinforced/brass,/turf/simulated/floor/indestructible/boss,/area/mine/necropolis)
"JB" = (/obj/structure/stone_tile/cracked{dir = 1},/obj/structure/stone_tile{dir = 4},/obj/structure/stone_tile,/obj/structure/stone_tile{dir = 8},/turf/simulated/floor/indestructible/boss,/area/mine/necropolis)
"Kg" = (/obj/structure/stone_tile,/obj/structure/stone_tile{dir = 4},/obj/structure/stone_tile{dir = 1},/obj/structure/stone_tile{dir = 8},/mob/living/simple_animal/hostile/asteroid/hivelord/legion,/turf/simulated/floor/indestructible/boss,/area/mine/necropolis)
"KY" = (/turf/simulated/mineral/random/high_chance/volcanic,/area/template_noop)
"Le" = (/obj/structure/stone_tile/block/cracked{dir = 8},/obj/structure/stone_tile{dir = 1},/obj/structure/stone_tile,/obj/structure/bookcase,/turf/simulated/floor/indestructible/boss,/area/mine/necropolis)
"LW" = (/obj/structure/stone_tile/block/cracked{dir = 4},/obj/structure/stone_tile/block{dir = 8},/obj/structure/table/reinforced/brass,/obj/item/weldingtool/experimental/brass,/turf/simulated/floor/indestructible/boss,/area/mine/necropolis)
"Or" = (/obj/structure/clockwork/wall_gear,/turf/simulated/wall/indestructible/boss,/area/mine/necropolis)
"Pa" = (/obj/structure/stone_tile/slab/cracked,/obj/structure/table/reinforced/brass,/turf/simulated/floor/indestructible/boss,/area/mine/necropolis)
"PA" = (/obj/structure/stone_tile/slab/cracked,/mob/living/simple_animal/hostile/asteroid/basilisk/watcher/magmawing,/turf/simulated/floor/indestructible/boss,/area/mine/necropolis)
"PH" = (/obj/structure/stone_tile,/obj/structure/stone_tile{dir = 4},/obj/structure/stone_tile{dir = 1},/obj/structure/stone_tile{dir = 8},/turf/simulated/wall/indestructible/boss,/area/mine/necropolis)
"RA" = (/obj/structure/stone_tile,/obj/structure/stone_tile{dir = 8},/obj/structure/stone_tile/block/cracked{dir = 1},/turf/simulated/floor/indestructible/boss,/area/mine/necropolis)
"RQ" = (/obj/structure/stone_tile/surrounding,/obj/structure/stone_tile/center/cracked,/obj/structure/bookcase,/turf/simulated/floor/indestructible/boss,/area/mine/necropolis)
"Sc" = (/obj/structure/stone_tile/cracked{dir = 4},/obj/structure/stone_tile{dir = 1},/obj/structure/stone_tile,/obj/structure/stone_tile{dir = 8},/obj/structure/chair/brass{dir = 1},/turf/simulated/floor/indestructible/boss,/area/mine/necropolis)
"SU" = (/obj/structure/stone_tile,/obj/structure/stone_tile{dir = 8},/obj/structure/stone_tile/block/cracked{dir = 1},/obj/item/clockwork/clockgolem_remains,/turf/simulated/floor/indestructible/boss,/area/mine/necropolis)
"Te" = (/turf/simulated/wall/indestructible/boss,/area/mine/necropolis)
"Up" = (/obj/structure/stone_tile/block/cracked{dir = 8},/obj/structure/stone_tile{dir = 1},/obj/structure/stone_tile,/turf/simulated/floor/indestructible/boss,/area/mine/necropolis)
"Vh" = (/obj/structure/stone_tile,/obj/structure/stone_tile{dir = 4},/obj/structure/stone_tile{dir = 1},/obj/structure/stone_tile{dir = 8},/mob/living/simple_animal/hostile/asteroid/basilisk/watcher/magmawing,/turf/simulated/floor/indestructible/boss,/area/mine/necropolis)
"Wl" = (/obj/structure/stone_tile,/obj/structure/stone_tile{dir = 4},/obj/structure/stone_tile{dir = 1},/obj/structure/stone_tile{dir = 8},/turf/simulated/floor/indestructible/boss,/area/mine/necropolis)
"XA" = (/obj/structure/stone_tile/block/cracked{dir = 4},/obj/structure/stone_tile/cracked{dir = 8},/obj/structure/stone_tile{dir = 4},/turf/simulated/floor/indestructible/boss,/area/mine/necropolis)
"Ye" = (/obj/structure/stone_tile/cracked{dir = 1},/obj/structure/stone_tile{dir = 4},/obj/structure/stone_tile,/obj/structure/stone_tile{dir = 8},/mob/living/simple_animal/hostile/asteroid/goliath/beast/ancient,/turf/simulated/floor/indestructible/boss,/area/mine/necropolis)
"Yn" = (/obj/structure/stone_tile/block/cracked{dir = 4},/obj/structure/stone_tile/cracked{dir = 8},/obj/structure/stone_tile{dir = 4},/obj/structure/bookcase,/turf/simulated/floor/indestructible/boss,/area/mine/necropolis)
"Yu" = (/obj/structure/stone_tile/cracked{dir = 4},/obj/structure/stone_tile{dir = 1},/obj/structure/stone_tile,/obj/structure/stone_tile{dir = 8},/obj/structure/table/reinforced/brass,/obj/item/storage/toolbox/brass,/turf/simulated/floor/indestructible/boss,/area/mine/necropolis)
"YF" = (/obj/structure/stone_tile/block/cracked{dir = 4},/obj/structure/stone_tile/block{dir = 8},/turf/simulated/floor/indestructible/boss,/area/mine/necropolis)
"Zz" = (/obj/structure/stone_tile/block/cracked{dir = 4},/obj/structure/stone_tile/block{dir = 8},/obj/structure/bookcase,/turf/simulated/floor/indestructible/boss,/area/mine/necropolis)
"ZC" = (/obj/structure/stone_tile/cracked{dir = 4},/obj/structure/stone_tile{dir = 1},/obj/structure/stone_tile,/obj/structure/stone_tile{dir = 8},/turf/simulated/floor/indestructible/boss,/area/mine/necropolis)
"ZD" = (/obj/structure/stone_tile,/obj/structure/stone_tile{dir = 4},/obj/structure/stone_tile{dir = 1},/obj/structure/stone_tile{dir = 8},/obj/structure/bookcase,/turf/simulated/floor/indestructible/boss,/area/mine/necropolis)
"ZL" = (/obj/structure/stone_tile/block/cracked{dir = 8},/obj/structure/stone_tile{dir = 1},/obj/structure/stone_tile,/mob/living/simple_animal/hostile/asteroid/basilisk/watcher/magmawing,/turf/simulated/floor/indestructible/boss,/area/mine/necropolis)
"ZM" = (/obj/structure/stone_tile/slab/cracked,/obj/structure/bookcase,/turf/simulated/floor/indestructible/boss,/area/mine/necropolis)

(1,1,1) = {"
ItItItItItItItItItItItItItItItItItItItItItItItItItItItItItItItItIt
ItTeTeTeTeTeTeTeTeTeTeTeTeTeTeTeTeTeTeTeTeTeTeTeTeTeTeTeTeTeTeTeIt
ItTeTeTeTeTeTeTeTeTeTeTeTeTeTeTeTeTeTeTeTeTeTeTeTeTeTeTeTeTeTeTeIt
ItTeTeTeTeTeTeTeTeTeTeTeTeTeTeTeTeTeTeTeTeTeTeTeTeTeTeTeTeTeTeTeIt
ItTeTeTeTeTeTeTeTeTeTeTeTeTeTeTeTeTeTeTeTeTeTeTeTeTeTeTeTeTeTeTeIt
ItTeTeTeTeTeTeTeTeTeTeTeTeTeTeTeTeTeTeTeTeTeTeTeTeTeTeTeTeTeTeTeIt
ItTeTeTeTeTeTeTeTeTeTeTeTeTeTeTeTeTeTeTeTeTeTeTeTeTeTeTeTeTeTeTeIt
ItTeTeTeTeOrLeZzttxcZMZDTeTeTeTeTeeSkvPaTeTeTeTeTeTeTeTeOrTeTeTeIt
ItTeTeTeYnVhRAZCpCWlYFXAZCOrTeOrYFXAuwCRWlOrTeTeTeTeDSPaiottTeTeIt
ItTeTePHZzzMlYYnRAYFRQGIUpTeTeRAZCYeRAZCnBTeTeTeTeZCYFzMbmXAZLTeIt
ItTeTeTedPUpWluhZCWlZCKgZCavZCbEYFZCWlUpavZCYFXAavWlRAZCvaRAZCYFIt
ItTeTeTeTeTeXAZCeGZCJBlYYFTeTeTePavKzMbETeTeTeTeTelYZCWlJBowavTeIt
ItTeTeTeTeTeOrYFbEzMGIZDTeTeTeTeTexcJiOrTeTeTeTeTeOrWlXADfioOrTeIt
ItTeTeTeTeTeTeTeLeZDTeTeTeTeTeTeTeTeTeTeTeTeYuDITeTeTeYFililililIt
ItilililililililililililililililTeTeTeTeOrCRWlSczMJBXAZCililililIt
ItililililililililililililililililTeTeTeDUXAZCYFZCPAWlSUililililIt
ItilililKYKYKYktktktktktKYKYililililTeTettjvzMiDRAxcOrilililililIt
ItililKYKYKYnqktktktktktktKYKYilililililTeavRAabEdLWililililItItIt
ItililKYGEktktktktktktktktktKYilililililililililililililililItItIt
ItItItItItItItItItItItItItItItItItItItItItItItItItItItItItItItItIt
"}
