//MAP CONVERTED BY dmm2tgm.py THIS HEADER COMMENT PREVENTS RECONVERSION, DO NOT REMOVE
"aN" = (
/obj/structure/lattice,
/obj/effect/decal/cleanable/dirt,
/turf/space,
/area/space/nearstation)
"aO" = (
/obj/structure/chair/stool/bar/dark{
	pixel_y = 13
	},
/obj/item/flashlight/lamp/green{
	glide_size = 5;
	step_size = 15;
	pixel_y = 41;
	pixel_x = -3
	},
/turf/simulated/floor/carpet/black,
/area/abandonedGhostbusters)
"bj" = (
/obj/structure/lattice,
/turf/space,
/area/abandonedGhostbusters)
"bm" = (
/obj/item/reagent_containers/food/snacks/ectoplasm{
	color = "green";
	pixel_x = -1;
	pixel_y = 4
	},
/turf/simulated/floor/carpet/black,
/area/abandonedGhostbusters)
"bJ" = (
/obj/structure/lattice,
/obj/item/pipe,
/turf/space,
/area/space)
"cK" = (
/obj/effect/decal/cleanable/dirt,
/obj/effect/decal/cleanable/dirt,
/obj/effect/decal/cleanable/dirt,
/obj/effect/decal/cleanable/dirt,
/turf/simulated/floor/plasteel,
/area/space/nearstation)
"du" = (
/obj/structure/holosign/barrier/atmos{
	icon_state = "phaseout"
	},
/obj/effect/landmark/tiles/damageturf,
/turf/simulated/floor/wood/cherry,
/area/space/nearstation)
"dw" = (
/obj/structure/lattice,
/turf/space,
/area/space)
"dB" = (
/obj/random/tool,
/turf/space,
/area/space/nearstation)
"dI" = (
/obj/structure/lattice,
/obj/machinery/atmospherics/trinary/tvalve/digital/bypass,
/turf/space,
/area/space/nearstation)
"eE" = (
/obj/structure/lattice,
/obj/item/kitchen/rollingpin,
/turf/space,
/area/space/nearstation)
"eW" = (
/obj/item/paper{
	name = "Помятая бумага";
	color = "gray";
	info = "<h2>Привет Игон!</h2>У меня потрясающие новости!<br> Я поймал нашего надоедливого зеленого призрака, который всё время воровал нашу еду. Запер его прямо здесь. Ни в коем случае не выпускай его, вероятно...Он будет злым. Да и касательного твоего рюкзака и ловушки...Я спрятал их у него. <br><br><b>Питер<b>";
	desc = "Помятая бумага"
	},
/obj/item/reagent_containers/food/snacks/ectoplasm{
	color = "green";
	pixel_y = -10
	},
/obj/effect/step_trigger/sound_effect/explosion_far{
	sound = list('sound/effects/ghostWake.ogg');
	name = "ghostWake";
	color = "green";
	icon_state = "heart"
	},
/turf/simulated/floor/plasteel{
	dir = 8;
	icon_state = "arrival"
	},
/area/abandonedGhostbusters)
"fj" = (
/obj/effect/decal/remains/human{
	pixel_y = 5;
	desc = "Останки покрытые непонятное зеленой слизью"
	},
/obj/effect/step_trigger/sound_effect/explosion_far{
	sound = list('sound/effects/ghostReading.ogg');
	name = "ghostReading";
	color = "green";
	pixel_y = 2;
	icon_state = "heart"
	},
/turf/simulated/floor/carpet/black,
/area/abandonedGhostbusters)
"fs" = (
/turf/simulated/floor/wood/cherry,
/area/abandonedGhostbusters)
"fz" = (
/obj/structure/lattice,
/obj/item/pipe{
	dir = 9
	},
/obj/machinery/atmospherics/unary/vent_pump/on{
	dir = 4
	},
/turf/space,
/area/space/nearstation)
"fG" = (
/obj/machinery/atmospherics/unary/vent_scrubber{
	dir = 8;
	name = "standard air scrubber";
	on = 1;
	scrub_N2O = 1;
	scrub_Toxins = 1
	},
/obj/effect/decal/cleanable/dirt,
/turf/simulated/floor/plasteel,
/area/space/nearstation)
"fM" = (
/obj/effect/decal/cleanable/dirt,
/turf/simulated/floor/plasteel{
	icon_state = "freezerfloor"
	},
/area/space/nearstation)
"fS" = (
/obj/machinery/washing_machine,
/obj/effect/decal/cleanable/dirt,
/turf/simulated/floor/plasteel{
	dir = 8;
	icon_state = "arrival"
	},
/area/space/nearstation)
"gB" = (
/obj/item/reagent_containers/food/snacks/ectoplasm{
	color = "green";
	pixel_y = -10
	},
/turf/simulated/floor/carpet/black,
/area/abandonedGhostbusters)
"gE" = (
/obj/structure/falsewall/mineral_ancient{
	desc = "Эта стена из крепкого камня выглядит так, как будто ее можно сдвинуть";
	name = "Подозрительная стена из камня"
	},
/obj/structure/sign/poster/contraband/ghostbusters_poster,
/turf/simulated/floor/carpet/red,
/area/abandonedGhostbusters)
"gU" = (
/obj/effect/decal/cleanable/dirt,
/turf/simulated/floor/carpet/black,
/area/abandonedGhostbusters)
"hq" = (
/obj/structure/falsewall/wood,
/turf/simulated/floor/carpet/black,
/area/abandonedGhostbusters)
"hG" = (
/obj/structure/table/wood/fancy/blue,
/turf/simulated/floor/carpet/black,
/area/abandonedGhostbusters)
"ih" = (
/obj/structure/chair/sofa/corp/left{
	dir = 1
	},
/turf/simulated/floor/carpet/black,
/area/abandonedGhostbusters)
"iv" = (
/obj/structure/cable,
/turf/simulated/floor/mineral,
/area/space/nearstation)
"iA" = (
/obj/effect/decal/cleanable/cobweb,
/obj/item/reagent_containers/food/snacks/ectoplasm{
	color = "green"
	},
/obj/effect/decal/ants,
/mob/living/simple_animal/hostile/ghost{
	mob_size = 3;
	health = 40;
	name = "Лизун";
	heat_damage_per_tick = 4;
	attacktext = "проникает сквозь тело";
	aggro_vision_range = 3;
	desc = "Неприятный зеленый призрак, полностью состоящий из эктоплазмы. Известен своей прожорливостью и слизью, которую оставляет за собой";
	harm_intent_damage = 2;
	melee_damage_upper = 2;
	icon_living = "kasper";
	icon_state = "kasper";
	icon_dead = "kasper";
	icon_resting = "kasper";
	loot = list(/obj/item/lighter/zippo/zippo_ghostbusters)
	},
/turf/simulated/floor/carpet/red,
/area/abandonedGhostbusters)
"iX" = (
/obj/structure/lattice,
/obj/structure/disposalpipe/segment,
/turf/space,
/area/space/nearstation)
"jb" = (
/obj/structure/chair/stool/bar/dark{
	pixel_x = 1;
	pixel_y = 10
	},
/obj/effect/decal/cleanable/cobweb2,
/turf/simulated/floor/carpet/black,
/area/abandonedGhostbusters)
"jh" = (
/obj/effect/decal/remains/robot,
/obj/structure/lattice,
/turf/space,
/area/space/nearstation)
"jo" = (
/obj/machinery/atmospherics/pipe/simple/hidden/scrubbers{
	dir = 4
	},
/obj/machinery/atmospherics/pipe/simple/hidden/supply{
	dir = 4
	},
/obj/structure/lattice,
/turf/space,
/area/space/nearstation)
"jq" = (
/obj/structure/lattice,
/obj/machinery/atmospherics/pipe/simple/hidden{
	dir = 8
	},
/turf/space,
/area/abandonedGhostbusters)
"jv" = (
/obj/effect/decal/cleanable/blood/old,
/obj/structure/chair/sofa/corp{
	dir = 1
	},
/turf/simulated/floor/carpet/black,
/area/abandonedGhostbusters)
"jK" = (
/obj/machinery/door/airlock/public{
	name = "Kitchen";
	req_access = list(28)
	},
/turf/simulated/floor/plasteel{
	icon_state = "redfull";
	tag = "icon-redfull (NORTHWEST)"
	},
/area/space/nearstation)
"jO" = (
/obj/structure/lattice,
/turf/simulated/wall/indestructible/boss/see_through{
	opacity = 1
	},
/area/abandonedGhostbusters)
"jX" = (
/obj/effect/decal/cleanable/tomato_smudge,
/turf/simulated/floor/wood/cherry,
/area/abandonedGhostbusters)
"kd" = (
/obj/structure/toilet{
	dir = 1
	},
/obj/machinery/door_control{
	desiredstate = 1;
	id = "toilet2";
	name = "Toilet Bolt Control";
	normaldoorcontrol = 1;
	pixel_y = -25;
	specialfunctions = 4
	},
/obj/effect/decal/cleanable/dirt,
/obj/effect/decal/cleanable/dirt,
/turf/simulated/floor/plasteel,
/area/space/nearstation)
"ky" = (
/obj/item/clothing/suit/ghost_sheet{
	color = "green"
	},
/turf/simulated/floor/carpet/red,
/area/abandonedGhostbusters)
"ll" = (
/obj/effect/decal/cleanable/dirt,
/turf/simulated/floor/mineral,
/area/space/nearstation)
"lu" = (
/obj/item/shard,
/turf/simulated/floor/mineral,
/area/space/nearstation)
"lM" = (
/obj/effect/decal/cleanable/dirt,
/obj/structure/chair/sofa/corp/right{
	dir = 1
	},
/turf/simulated/floor/carpet/black,
/area/abandonedGhostbusters)
"mz" = (
/obj/structure/table/reinforced,
/turf/simulated/floor/plasteel{
	icon_state = "white"
	},
/area/space)
"mK" = (
/obj/structure/lattice,
/obj/item/storage/toolbox,
/turf/space,
/area/space/nearstation)
"mW" = (
/obj/effect/spawner/window{
	color = "gray"
	},
/turf/simulated/floor/carpet/blue,
/area/abandonedGhostbusters)
"nq" = (
/obj/structure/lattice,
/obj/item/paper_bin,
/turf/space,
/area/space/nearstation)
"ny" = (
/obj/structure/table/wood/fancy/black,
/obj/item/reagent_containers/food/drinks/coffee,
/turf/simulated/floor/carpet/red,
/area/abandonedGhostbusters)
"nO" = (
/turf/template_noop,
/area/template_noop)
"nT" = (
/obj/structure/lattice,
/turf/space,
/area/space/nearstation)
"oE" = (
/obj/structure/lattice,
/obj/structure/disposalpipe/segment{
	dir = 2
	},
/turf/space,
/area/space/nearstation)
"oQ" = (
/obj/structure/table/wood/fancy/black,
/obj/item/camera/spooky{
	pixel_y = 2
	},
/turf/simulated/floor/light{
	color = "red";
	light_color = "red"
	},
/area/abandonedGhostbusters)
"oR" = (
/obj/structure/holosign/barrier/atmos{
	icon_state = "phaseout"
	},
/turf/simulated/floor/wood{
	icon_state = "wood-broken3"
	},
/area/space/nearstation)
"oU" = (
/obj/structure/lattice,
/obj/structure/lattice,
/turf/simulated/mineral,
/area/space/nearstation)
"qt" = (
/obj/effect/landmark/tiles/damageturf,
/turf/simulated/wall,
/area/space)
"qy" = (
/obj/item/nullrod/salt{
	pixel_x = 1;
	pixel_y = 6
	},
/obj/structure/table/wood/fancy/black,
/turf/simulated/floor/light{
	color = "red";
	light_color = "red"
	},
/area/abandonedGhostbusters)
"qE" = (
/turf/simulated/mineral/random/volcanic/hard/double/high_chance,
/area/space/nearstation)
"qS" = (
/obj/effect/decal/cleanable/dirt,
/obj/structure/chair/sofa/corp{
	dir = 1
	},
/obj/structure/lattice,
/turf/simulated/floor/carpet/black,
/area/abandonedGhostbusters)
"rl" = (
/turf/simulated/floor/plating,
/area/abandonedGhostbusters)
"rC" = (
/obj/structure/lattice,
/obj/item/shard,
/turf/space,
/area/space/nearstation)
"sx" = (
/turf/simulated/floor/wood{
	icon_state = "wood-broken3"
	},
/area/space/nearstation)
"sB" = (
/obj/structure/fence,
/obj/structure/sign/poster/official/religious{
	pixel_x = -31
	},
/turf/simulated/floor/carpet/black,
/area/abandonedGhostbusters)
"sF" = (
/obj/machinery/door/poddoor/preopen,
/obj/item/shard,
/turf/space,
/area/space/nearstation)
"tz" = (
/obj/effect/decal/cleanable/dirt,
/obj/effect/landmark/tiles/damageturf,
/turf/simulated/floor/wood/cherry,
/area/abandonedGhostbusters)
"tF" = (
/obj/structure/lattice,
/turf/simulated/mineral,
/area/space/nearstation)
"tW" = (
/turf/simulated/floor/carpet/black,
/area/abandonedGhostbusters)
"ui" = (
/obj/machinery/atmospherics/unary/vent_scrubber{
	name = "standard air scrubber";
	on = 1;
	scrub_N2O = 1;
	scrub_Toxins = 1
	},
/obj/effect/decal/cleanable/dirt,
/turf/space,
/area/space/nearstation)
"ur" = (
/obj/effect/decal/cleanable/dirt,
/obj/effect/decal/cleanable/confetti,
/obj/effect/decal/cleanable/blood/slime{
	color = "red"
	},
/obj/structure/table/reinforced,
/obj/item/seeds/chili/ghost{
	pixel_x = -6;
	pixel_y = -1
	},
/turf/simulated/floor/carpet/red,
/area/abandonedGhostbusters)
"uK" = (
/obj/effect/spawner/random_barrier,
/turf/space,
/area/space/nearstation)
"uO" = (
/obj/structure/lattice,
/obj/item/pipe,
/turf/space,
/area/space/nearstation)
"va" = (
/turf/simulated/wall,
/area/space/nearstation)
"vj" = (
/obj/structure/grille/broken,
/turf/simulated/floor/plating,
/area/abandonedGhostbusters)
"vl" = (
/obj/item/reagent_containers/food/snacks/ectoplasm{
	color = "green";
	pixel_x = -1;
	pixel_y = 4
	},
/turf/space,
/area/space/nearstation)
"vz" = (
/obj/machinery/atmospherics/pipe/simple/hidden/scrubbers{
	dir = 4
	},
/obj/machinery/atmospherics/pipe/simple/hidden/supply{
	dir = 4
	},
/obj/effect/decal/cleanable/dirt,
/turf/simulated/floor/plasteel{
	icon_state = "freezerfloor"
	},
/area/space/nearstation)
"vT" = (
/obj/item/trash/tastybread{
	pixel_x = -7;
	pixel_y = 18
	},
/turf/simulated/floor/wood/cherry,
/area/abandonedGhostbusters)
"vY" = (
/obj/structure/table/wood/fancy,
/obj/item/paper{
	desc = "Мятый лист бумаги";
	info = "<h1> Инструкция для начинающих охотников за призраками </h1><b>Шаг 1: Подготовьтесь</b><br>Перед тем, как отправиться на охоту за призраками, убедитесь, что вы готовы к этому приключению. Учтите следующие важные моменты:Изучите место, где вы собираетесь охотиться. Информация о его истории и предполагаемых призрачных явлениях будет весьма полезной.Наденьте удобную одежду и обувь, которые позволят вам комфортно передвигаться и проводить длительное время на месте. Возьмите с собой несколько источников света, фонарь. Вы не захотите оказаться в полной темноте.<b><br>Шаг 2: Используйте соль</b><br>Святая соль считается мощным средством для отпугивания злых духов. Важно знать, как ею пользоваться:Разбросайте святую соль вокруг себя или в местах, где предполагается наличие призрачных активностей.Создайте защитный круг из соли вокруг себя, чтобы предотвратить приближение нежелательных сущностей.Периодически обновляйте слой соли, особенно если чувствуете, что уровень активности призраков увеличивается.<b><br>Шаг 3: Используйте  фотоаппарат</b><br>Для фотографирования призраков, которых нельзя видеть невооруженным глазом, пригодится специальный фотоаппарат. Перед фотосъемкой, окружите место солью и призовите призраков, призывая их позировать. Сделайте несколько снимков и оцените результаты после возвращения домой. Призраки могут появляться на фотографиях в виде неясных образов или светящихся фигур.<b><br>Шаг 4: Используйте ловушку для призраков!</b><br>Экспериментальное устройство разработано специально для дружелюбных призраков и других существ. Приманите дружелюбного призрака или другое не опасное существо. Поставьте ловушку в удобном месте. Как только призрак окажется над ловушкой - мягкое свечение внутри затянет его внутрь, обеспечивая безопасное и комфортное заключение. Так как образец экспериментальный, возможно потребуется затолкнуть туда существо силой...<br><b>Шаг 5: Используйте протонный ранец</b><br>Экспериментальное оружие против призрачной энергии, мгновенно очищает пол и стены от их едкой слизи!<br><b>Шаг 6: Оставайтесь спокойными и внимательными</b><br>Охота за призраками может быть увлекательным, но также и пугающим. Важно помнить следующие советы:<br>Оставайтесь спокойными и уважительными во время охоты. Не провоцируйте духов или не призывайте их слишком настойчиво. Будьте внимательными к своим ощущениям и интуиции. Иногда призраки могут подавать знаки своего присутствия через зудение кожи, холод или странные шумы.<br><br><b>Удачи в вашей охоте за призраками!<br> Помните, что уважение и осторожность - ключи к успешному и безопасному исследованию мистического мира.<br> Эй, никто не видел мой протонный рюкзак и ловушку? Пите...</b";
	name = "Памятка Охотникам За Призраками";
	pixel_y = 5;
	color = "gray"
	},
/turf/simulated/floor/carpet/black,
/area/abandonedGhostbusters)
"ww" = (
/obj/structure/lattice,
/obj/item/pickaxe,
/turf/space,
/area/space/nearstation)
"wz" = (
/obj/effect/decal/cleanable/dirt,
/obj/effect/decal/cleanable/dirt,
/obj/structure/chair/sofa/corp{
	dir = 1
	},
/turf/simulated/floor/carpet/black,
/area/abandonedGhostbusters)
"wN" = (
/obj/structure/bed/dogbed/pet,
/mob/living/simple_animal/mouse/rat/white{
	name = "Зефирка";
	real_name = "Зефирка";
	dir = 8;
	desc = "Выглядит очень упитанной, пахнет зефиром."
	},
/turf/simulated/floor/wood/cherry,
/area/abandonedGhostbusters)
"xa" = (
/obj/structure/lattice,
/obj/effect/spawner/random_barrier/obstruction,
/turf/space,
/area/space/nearstation)
"xg" = (
/obj/structure/sign/fire{
	pixel_y = 32
	},
/turf/template_noop,
/area/template_noop)
"xK" = (
/turf/simulated/mineral,
/area/space)
"yi" = (
/obj/machinery/atmospherics/pipe/simple/hidden{
	dir = 9
	},
/turf/simulated/mineral,
/area/abandonedGhostbusters)
"yv" = (
/turf/simulated/floor/plating/asteroid/airless,
/area/space)
"yA" = (
/turf/simulated/floor/plating/asteroid/airless,
/area/space/nearstation)
"zg" = (
/obj/structure/lattice,
/obj/machinery/atmospherics/pipe/simple/hidden,
/obj/structure/cable/blue,
/turf/space,
/area/space/nearstation)
"zw" = (
/obj/structure/table/wood/fancy/black,
/obj/item/reagent_containers/food/snacks/grown/ghost_chili{
	pixel_x = 3;
	pixel_y = 5
	},
/obj/item/reagent_containers/food/snacks/grown/ghost_chili{
	pixel_x = -7;
	pixel_y = 6
	},
/turf/simulated/floor/carpet/black,
/area/abandonedGhostbusters)
"zZ" = (
/obj/effect/decal/cleanable/dirt,
/turf/simulated/wall,
/area/space/nearstation)
"Ag" = (
/obj/effect/decal/cleanable/dirt,
/obj/effect/decal/ants,
/turf/simulated/floor/wood/cherry,
/area/abandonedGhostbusters)
"Al" = (
/obj/structure/lattice,
/turf/simulated/mineral,
/area/abandonedGhostbusters)
"AG" = (
/obj/structure/lattice,
/turf/simulated/floor/plating/asteroid/airless,
/area/space/nearstation)
"Bt" = (
/obj/structure/rack{
	dir = 8;
	layer = 2.9
	},
/obj/item/watertank/janitor/ghostwaterbackpack,
/turf/simulated/floor/light{
	color = "red";
	light_color = "red"
	},
/area/abandonedGhostbusters)
"Cn" = (
/obj/item/candle/eternal,
/turf/simulated/floor/carpet/black,
/area/abandonedGhostbusters)
"Cs" = (
/obj/item/pipe,
/obj/structure/lattice,
/turf/space,
/area/space/nearstation)
"CA" = (
/obj/structure/lattice,
/obj/machinery/atmospherics/pipe/simple/hidden/universal,
/turf/space,
/area/space/nearstation)
"CH" = (
/obj/effect/decal/cleanable/dirt,
/obj/structure/sign/poster/random,
/turf/simulated/wall/indestructible/wood,
/area/abandonedGhostbusters)
"CU" = (
/obj/structure/table/wood/fancy/black,
/obj/item/flashlight/lamp/green,
/turf/simulated/floor/carpet/red,
/area/abandonedGhostbusters)
"DC" = (
/obj/machinery/light_construct{
	dir = 8
	},
/turf/simulated/floor/wood/cherry,
/area/abandonedGhostbusters)
"DS" = (
/turf/simulated/mineral,
/area/space/nearstation)
"Ei" = (
/obj/item/trash/semki,
/turf/simulated/mineral/random/volcanic/hard/double/high_chance,
/area/space/nearstation)
"Et" = (
/obj/effect/decal/cleanable/dirt,
/obj/effect/decal/ants,
/turf/simulated/floor/plasteel{
	icon_state = "freezerfloor"
	},
/area/space/nearstation)
"EC" = (
/turf/space,
/area/space/nearstation)
"ED" = (
/obj/effect/spawner/lootdrop/maintenance{
	pixel_y = 3;
	pixel_x = 7
	},
/obj/effect/decal/cleanable/dirt,
/obj/effect/step_trigger/sound_effect/explosion_far{
	sound = list('sound/effects/ghostWrench.ogg');
	name = "ghostWrench";
	color = "green";
	icon_state = "heart"
	},
/obj/effect/decal/cleanable/confetti,
/turf/simulated/floor/carpet/black,
/area/abandonedGhostbusters)
"Fj" = (
/turf/simulated/mineral/random/volcanic/hard/double/high_chance,
/area/space)
"Fo" = (
/turf/simulated/wall/indestructible/wood,
/area/abandonedGhostbusters)
"FG" = (
/obj/item/broken_bottle,
/turf/simulated/floor/wood/cherry,
/area/abandonedGhostbusters)
"FO" = (
/obj/machinery/door/poddoor/multi_tile,
/turf/space,
/area/space/nearstation)
"GS" = (
/obj/machinery/atmospherics/unary/passive_vent,
/turf/space,
/area/space)
"Hn" = (
/obj/structure/table_frame/wood,
/obj/item/stack/sheet/wood,
/obj/effect/decal/cleanable/cobweb2,
/turf/simulated/floor/wood/cherry,
/area/abandonedGhostbusters)
"Hq" = (
/turf/space,
/area/space)
"HL" = (
/obj/item/flashlight{
	pixel_x = -1;
	pixel_y = 8
	},
/obj/structure/table/wood/fancy/blue,
/turf/simulated/floor/light{
	color = "red";
	light_color = "red"
	},
/area/abandonedGhostbusters)
"HU" = (
/obj/structure/table_frame/wood,
/turf/simulated/floor/wood{
	icon_state = "wood-broken"
	},
/area/abandonedGhostbusters)
"Ia" = (
/obj/effect/landmark/tiles/damageturf,
/turf/simulated/floor/carpet/black,
/area/abandonedGhostbusters)
"It" = (
/obj/item/shard,
/obj/structure/lattice,
/turf/space,
/area/space/nearstation)
"IU" = (
/obj/item/shard,
/turf/simulated/floor/plating/asteroid/airless,
/area/space/nearstation)
"IX" = (
/obj/structure/lattice,
/obj/machinery/atmospherics/pipe/simple/hidden{
	dir = 5
	},
/obj/structure/cable/blue,
/turf/space,
/area/abandonedGhostbusters)
"Jk" = (
/obj/effect/spawner/random_barrier/obstruction,
/turf/space,
/area/space/nearstation)
"Ju" = (
/obj/effect/decal/cleanable/blood/tracks{
	pixel_x = -1;
	pixel_y = -16;
	color = "green"
	},
/turf/simulated/floor/carpet/black,
/area/abandonedGhostbusters)
"JD" = (
/obj/structure/lattice/catwalk,
/obj/item/pipe,
/turf/space,
/area/space/nearstation)
"Kg" = (
/obj/item/trash/syndi_cakes{
	pixel_y = 7
	},
/obj/effect/decal/ants,
/obj/item/trash/semki{
	pixel_y = 2;
	pixel_x = -22
	},
/turf/simulated/floor/wood/cherry,
/area/abandonedGhostbusters)
"Ky" = (
/obj/structure/lattice,
/obj/item/trash/waffles,
/turf/space,
/area/space/nearstation)
"KJ" = (
/obj/effect/decal/cleanable/dirt,
/obj/effect/decal/cleanable/blood/tracks{
	dir = 8;
	pixel_x = -6;
	pixel_y = 10;
	color = "green"
	},
/turf/simulated/floor/carpet/black,
/area/abandonedGhostbusters)
"KV" = (
/turf/simulated/wall/indestructible/boss/see_through{
	opacity = 1
	},
/area/abandonedGhostbusters)
"Lj" = (
/obj/effect/dummy/lighting_obj,
/obj/effect/decal/cleanable/cobweb,
/turf/simulated/floor/carpet/red,
/area/abandonedGhostbusters)
"LP" = (
/obj/structure/disposalpipe/trunk,
/turf/space,
/area/space)
"Mc" = (
/obj/structure/lattice,
/obj/item/stack/cable_coil,
/turf/space,
/area/space/nearstation)
"Mo" = (
/obj/structure/rack{
	dir = 8;
	layer = 2.9
	},
/obj/item/ghost_trap,
/turf/simulated/floor/light{
	color = "red";
	light_color = "red"
	},
/area/abandonedGhostbusters)
"Mp" = (
/obj/effect/decal/cleanable/blood/old,
/turf/simulated/floor/carpet/black,
/area/abandonedGhostbusters)
"Mu" = (
/obj/structure/table/reinforced,
/obj/machinery/kitchen_machine/microwave{
	pixel_x = -1;
	pixel_y = 7
	},
/turf/simulated/floor/plasteel{
	icon_state = "white"
	},
/area/space/nearstation)
"MH" = (
/obj/machinery/door/airlock{
	id_tag = "toilet2";
	name = "Toilet"
	},
/turf/simulated/floor/plasteel,
/area/space/nearstation)
"Nx" = (
/obj/structure/sign/poster/official/walk,
/obj/structure/falsewall/mineral_ancient{
	name = "Подозрительная стена из камня";
	desc = "Эта стена из крепкого камня выглядит так, как будто ее можно сдвинуть"
	},
/turf/simulated/floor/carpet/red,
/area/abandonedGhostbusters)
"NW" = (
/obj/item/chair/wood,
/turf/simulated/floor/wood/cherry,
/area/abandonedGhostbusters)
"Ou" = (
/obj/effect/decal/cleanable/dirt,
/obj/structure/sign/poster/contraband/ghostbusters_poster{
	pixel_x = -32
	},
/turf/simulated/floor/carpet/black,
/area/abandonedGhostbusters)
"OG" = (
/obj/structure/closet/cabinet,
/obj/effect/decal/cleanable/egg_smudge,
/obj/item/wrench,
/obj/effect/step_trigger/sound_effect/explosion_far{
	sound = list('sound/effects/ghostWrench.ogg');
	name = "ghostWrench";
	color = "green";
	icon_state = "heart"
	},
/turf/simulated/floor/wood{
	icon_state = "wood-broken"
	},
/area/abandonedGhostbusters)
"OH" = (
/obj/structure/spacepod_frame,
/obj/structure/cable,
/obj/structure/lattice,
/turf/space,
/area/space/nearstation)
"Pt" = (
/turf/simulated/floor/mineral,
/area/space/nearstation)
"PR" = (
/obj/item/trash/tray{
	pixel_y = 3
	},
/turf/simulated/floor/wood/cherry,
/area/abandonedGhostbusters)
"Qf" = (
/obj/structure/table/holotable/wood,
/obj/item/reagent_containers/food/drinks/coffee{
	glide_size = 5;
	pixel_y = 1;
	pixel_x = -5
	},
/obj/item/reagent_containers/food/drinks/coffee{
	pixel_y = 14;
	pixel_x = 7
	},
/obj/item/reagent_containers/food/snacks/donut/sprinkles{
	pixel_x = 7
	},
/obj/structure/table/holotable/wood,
/turf/simulated/floor/carpet/black,
/area/abandonedGhostbusters)
"Qx" = (
/obj/structure/lattice,
/obj/machinery/computer/rdconsole/mechanics,
/turf/space,
/area/space/nearstation)
"QC" = (
/obj/structure/lattice,
/obj/structure/cable,
/turf/space,
/area/abandonedGhostbusters)
"QF" = (
/obj/structure/window/reinforced{
	dir = 4
	},
/obj/effect/decal/cleanable/dirt,
/turf/simulated/floor/plasteel{
	dir = 8;
	icon_state = "arrival"
	},
/area/space/nearstation)
"RI" = (
/turf/simulated/mineral/random/high_chance,
/area/space/nearstation)
"Sq" = (
/obj/effect/decal/cleanable/cobweb2,
/obj/structure/closet/wardrobe{
	name = "Одежда";
	color = "gray"
	},
/obj/item/clothing/under/color/black/ghost{
	name = "Комбинезон охотника за приведениями";
	desc = "Невероятно удобный комбинезон для охоты на приведений"
	},
/obj/item/clothing/shoes/galoshes/dry{
	name = "Галоши охотника за приведениями";
	desc = "Пара очень удобных галош для охоты на призраков";
	color = "grey"
	},
/turf/simulated/floor/carpet/red,
/area/abandonedGhostbusters)
"TT" = (
/obj/item/wirecutters,
/obj/effect/decal/cleanable/cobweb,
/obj/effect/decal/cleanable/cobweb2,
/obj/structure/sign/holy{
	pixel_x = -31
	},
/obj/effect/step_trigger/sound_effect/explosion_far{
	sound = list('sound/effects/ghostEnter.ogg');
	name = "ghostEnter";
	color = "green";
	icon_state = "heart"
	},
/turf/simulated/floor/carpet/black,
/area/abandonedGhostbusters)
"Ua" = (
/obj/structure/falsewall/wood{
	name = "Подозрительная деревянная стена";
	desc = "Она кажется подвижной"
	},
/obj/structure/sign/poster/ripped,
/obj/effect/step_trigger/sound_effect/explosion_far{
	sound = list('sound/effects/ghostOpen.ogg');
	name = "ghostOpen";
	color = "green";
	icon_state = "heart"
	},
/turf/space,
/area/space/nearstation)
"Um" = (
/turf/simulated/floor/plasteel{
	icon_state = "redfull";
	tag = "icon-redfull (NORTHWEST)"
	},
/area/space/nearstation)
"UJ" = (
/obj/structure/lattice,
/obj/machinery/shower{
	dir = 8;
	tag = "icon-shower (WEST)"
	},
/obj/structure/curtain/open/shower,
/turf/space,
/area/space/nearstation)
"Vl" = (
/obj/item/decorations/sticky_decorations/flammable/ghost,
/obj/structure/sign/poster/official/the_owl{
	pixel_x = -31
	},
/turf/simulated/floor/carpet/black,
/area/abandonedGhostbusters)
"VP" = (
/turf/simulated/floor/wood{
	icon_state = "wood-broken3"
	},
/area/abandonedGhostbusters)
"Wr" = (
/obj/structure/table/wood/fancy/blue,
/turf/simulated/floor/light{
	color = "red";
	light_color = "red"
	},
/area/abandonedGhostbusters)
"WH" = (
/obj/structure/window/reinforced{
	dir = 4
	},
/turf/simulated/floor/plating/asteroid/airless,
/area/space/nearstation)
"Xt" = (
/obj/effect/landmark/tiles/damageturf,
/obj/machinery/atmospherics/unary/vent_pump/on{
	dir = 1
	},
/turf/simulated/floor/plasteel{
	icon_state = "freezerfloor"
	},
/area/space/nearstation)
"XH" = (
/obj/structure/cable,
/obj/structure/lattice,
/turf/space,
/area/space/nearstation)
"Ya" = (
/obj/effect/decal/cleanable/dirt,
/turf/simulated/wall,
/area/space)
"YC" = (
/obj/effect/decal/cleanable/dirt,
/obj/item/reagent_containers/food/snacks/ectoplasm{
	color = "green";
	pixel_x = -1;
	pixel_y = 4
	},
/turf/simulated/floor/plating,
/area/abandonedGhostbusters)
"YE" = (
/turf/simulated/mineral/random/high_chance,
/area/abandonedGhostbusters)
"YN" = (
/obj/structure/falsewall/wood{
	name = "Подозрительная деревянная стена";
	desc = "Она кажется подвижной"
	},
/obj/structure/sign/poster/ripped,
/turf/simulated/floor/carpet/black,
/area/abandonedGhostbusters)
"YR" = (
/obj/structure/lattice,
/obj/structure/cable,
/obj/machinery/power/apc{
	dir = 1;
	name = "north bump";
	pixel_y = 26
	},
/turf/space,
/area/abandonedGhostbusters)
"YX" = (
/obj/effect/decal/cleanable/cobweb2,
/obj/item/reagent_containers/food/snacks/ectoplasm,
/obj/item/reagent_containers/food/snacks/ectoplasm{
	color = "green"
	},
/obj/item/reagent_containers/food/snacks/baconpizzaslice{
	color = "green";
	pixel_y = 7;
	pixel_x = -2;
	desc = "Кусочек пиццы в непонятной зеленой слизи..."
	},
/obj/item/trash/semki{
	pixel_y = -7;
	pixel_x = 9
	},
/obj/item/trash/tray{
	pixel_x = -10;
	pixel_y = -9
	},
/turf/simulated/floor/carpet/red,
/area/abandonedGhostbusters)
"Zi" = (
/obj/effect/decal/cleanable/dirt,
/obj/effect/decal/cleanable/ash,
/turf/simulated/floor/carpet/red,
/area/abandonedGhostbusters)
"Zm" = (
/obj/structure/lattice,
/obj/item/reagent_containers/food/snacks/meat,
/turf/space,
/area/space/nearstation)
"Zu" = (
/obj/effect/decal/cleanable/dirt,
/obj/effect/landmark/tiles/damageturf,
/turf/simulated/wall,
/area/space/nearstation)
"ZO" = (
/obj/effect/decal/remains/mouse,
/turf/space,
/area/space/nearstation)
"ZT" = (
/obj/item/shard,
/turf/space,
/area/space/nearstation)

(1,1,1) = {"
nO
nO
nO
nO
nO
nO
nO
nO
nO
nO
nO
nO
nO
nO
nO
nO
nO
nO
nO
nO
nO
nO
nO
nO
nO
"}
(2,1,1) = {"
nO
nO
nO
nO
nO
nO
nO
nO
nO
nO
nO
nO
nO
nO
nO
nO
nO
nO
nO
nO
nO
nO
nO
nO
nO
"}
(3,1,1) = {"
nO
nO
nO
Hq
Hq
Hq
Fj
Hq
Hq
DS
jK
dw
Hq
Hq
Hq
Hq
Hq
Hq
Hq
Hq
Hq
Hq
Hq
nO
nO
"}
(4,1,1) = {"
nO
nO
nO
Hq
Hq
Hq
DS
AG
DS
DS
Zm
Jk
xK
RI
qE
qE
qE
RI
dw
Hq
Hq
Hq
Hq
nO
nO
"}
(5,1,1) = {"
nO
nO
nO
Hq
Hq
qE
EC
DS
mz
nT
dI
ZT
Pt
Um
RI
EC
FO
sF
Pt
nT
Hq
Hq
Hq
nO
nO
"}
(6,1,1) = {"
nO
nO
nO
Hq
Fj
EC
rC
DS
Mu
eE
nT
Um
nT
nT
DS
RI
iv
OH
XH
mK
EC
Hq
Hq
nO
nO
"}
(7,1,1) = {"
nO
nO
nO
Hq
Fj
qE
nT
yA
RI
RI
RI
Ky
oU
tF
nT
RI
It
Pt
lu
Qx
yA
yA
Hq
nO
nO
"}
(8,1,1) = {"
nO
nO
nO
Hq
Fj
DS
zg
IX
KV
KV
KV
KV
KV
KV
KV
KV
KV
jO
Al
nT
yv
EC
Hq
nO
nO
"}
(9,1,1) = {"
nO
nO
nO
Hq
Hq
DS
qE
KV
KV
Lj
ky
sB
TT
Ou
Vl
Ia
hq
ED
KV
yA
cK
zZ
Ya
nO
nO
"}
(10,1,1) = {"
nO
nO
nO
xK
Hq
RI
RI
KV
oQ
gU
tW
CH
Fo
Fo
YN
Fo
Fo
Fo
KV
RI
MH
kd
qt
nO
nO
"}
(11,1,1) = {"
nO
nO
nO
xK
dw
AG
DS
KV
zw
vj
Mp
lM
Fo
CU
ny
DC
rl
du
Ua
qE
fG
Zu
va
xg
nO
"}
(12,1,1) = {"
nO
nO
nO
Hq
xK
dI
ZT
KV
qy
Cn
gU
qS
Fo
OG
tz
jX
VP
oR
KV
DS
qE
qE
DS
nO
nO
"}
(13,1,1) = {"
nO
nO
nO
Hq
Hq
oE
iX
KV
vY
fj
bm
wz
Fo
HU
PR
Ag
vT
fs
KV
DS
qE
DS
qE
nO
nO
"}
(14,1,1) = {"
nO
nO
nO
Hq
Hq
ww
DS
KV
Wr
Cn
KJ
jv
Fo
Hn
NW
FG
Kg
wN
KV
yA
Fj
nT
aN
nO
nO
"}
(15,1,1) = {"
nO
nO
nO
Hq
Hq
DS
DS
KV
hG
tW
YC
ih
Fo
Fo
Fo
Fo
Fo
Fo
KV
nT
Pt
ll
qE
nO
nO
"}
(16,1,1) = {"
nO
nO
nO
Hq
yv
yA
RI
KV
HL
gU
Ju
gB
Nx
Zi
eW
mW
iA
Bt
KV
ui
Et
Xt
sx
nO
nO
"}
(17,1,1) = {"
nO
nO
nO
Hq
Hq
yA
DS
KV
KV
jb
Qf
aO
gE
Sq
ur
mW
YX
Mo
KV
fM
vz
UJ
qE
nO
nO
"}
(18,1,1) = {"
nO
nO
nO
dw
Hq
yA
Mc
jq
KV
KV
KV
KV
KV
KV
KV
KV
KV
jO
bj
nT
jo
va
qE
nO
nO
"}
(19,1,1) = {"
nO
nO
nO
Hq
bJ
xa
CA
yi
YE
QC
YR
DS
jh
yA
RI
RI
RI
vl
uK
dB
fS
nT
nq
nO
nO
"}
(20,1,1) = {"
nO
nO
nO
Hq
dw
EC
LP
RI
DS
ZO
uO
DS
Cs
yA
JD
uO
fz
RI
Ei
EC
WH
IU
QF
nO
nO
"}
(21,1,1) = {"
nO
nO
nO
Hq
Hq
Hq
Hq
Hq
qE
DS
DS
DS
DS
Fj
Hq
Hq
dw
dw
qE
qE
Hq
Hq
Hq
nO
nO
"}
(22,1,1) = {"
nO
nO
nO
Hq
Hq
Hq
Hq
Hq
qE
qE
qE
qE
Hq
Hq
Hq
GS
Hq
Hq
Hq
qE
Hq
Hq
Hq
nO
nO
"}
(23,1,1) = {"
nO
nO
nO
Hq
Hq
Hq
Hq
Hq
Hq
Hq
Hq
Hq
Hq
Hq
Hq
Hq
Hq
Hq
Hq
Hq
Hq
Hq
Hq
nO
nO
"}
(24,1,1) = {"
nO
nO
nO
nO
nO
nO
nO
nO
nO
nO
nO
nO
nO
nO
nO
nO
nO
nO
nO
nO
nO
nO
nO
nO
nO
"}
(25,1,1) = {"
nO
nO
nO
nO
nO
nO
nO
nO
nO
nO
nO
nO
nO
nO
nO
nO
nO
nO
nO
nO
nO
nO
nO
nO
nO
"}
