//MAP CONVERTED BY dmm2tgm.py THIS HEADER COMMENT PREVENTS RECONVERSION, DO NOT REMOVE
"ax" = (
/mob/living/simple_animal/hostile/asteroid/basilisk,
/turf/simulated/floor/plating/asteroid,
/area/ruin/unpowered)
"bq" = (
/obj/structure/table/reinforced,
/obj/item/storage/box/syringes{
	pixel_x = 5;
	pixel_y = 5
	},
/obj/item/storage/box/beakers,
/obj/machinery/light{
	dir = 4
	},
/turf/simulated/floor/plasteel{
	icon_state = "dark"
	},
/area/ruin/unpowered)
"dm" = (
/obj/structure/grille,
/obj/item/shard{
	icon_state = "medium"
	},
/obj/structure/cable{
	icon_state = "0-8"
	},
/turf/simulated/floor/plating/airless,
/area/ruin/unpowered)
"dr" = (
/obj/structure/flora/rock,
/obj/machinery/light,
/turf/simulated/floor/plating/asteroid,
/area/ruin/unpowered)
"dx" = (
/obj/structure/cable{
	icon_state = "1-2"
	},
/turf/simulated/floor/plasteel{
	icon_state = "dark"
	},
/area/ruin/unpowered)
"es" = (
/obj/structure/grille,
/obj/structure/window/full/reinforced,
/obj/structure/cable{
	icon_state = "1-2"
	},
/obj/structure/cable{
	icon_state = "0-2"
	},
/turf/simulated/floor/plating/airless,
/area/ruin/unpowered)
"eM" = (
/obj/machinery/smartfridge/secure/chemistry,
/turf/simulated/floor/plasteel{
	icon_state = "dark"
	},
/area/ruin/unpowered)
"fg" = (
/obj/machinery/shieldwallgen{
	anchored = 1
	},
/obj/structure/cable{
	icon_state = "2-8"
	},
/obj/structure/cable{
	icon_state = "0-2"
	},
/turf/simulated/floor/plating/airless,
/area/ruin/unpowered)
"fT" = (
/obj/machinery/disposal,
/obj/structure/disposalpipe/trunk{
	dir = 1
	},
/turf/simulated/floor/plasteel{
	icon_state = "dark"
	},
/area/ruin/unpowered)
"fX" = (
/obj/machinery/light,
/mob/living/simple_animal/hostile/poison/bees,
/turf/simulated/floor/grass,
/area/ruin/unpowered)
"gb" = (
/obj/structure/grille,
/obj/structure/window/full/reinforced,
/obj/structure/cable{
	icon_state = "4-8"
	},
/obj/structure/cable{
	icon_state = "0-8"
	},
/obj/structure/disposalpipe/segment{
	dir = 4
	},
/turf/simulated/floor/plating/airless,
/area/ruin/unpowered)
"go" = (
/obj/structure/disposalpipe/segment,
/turf/simulated/floor/plating/airless,
/area/space/nearstation)
"gp" = (
/obj/structure/flora/ausbushes/leafybush,
/mob/living/simple_animal/hostile/poison/bees,
/turf/simulated/floor/grass,
/area/ruin/unpowered)
"hh" = (
/obj/structure/table/reinforced,
/obj/item/surgicaldrill,
/obj/item/hemostat,
/obj/item/scalpel,
/obj/item/surgical_drapes,
/obj/item/retractor,
/obj/item/cautery,
/obj/item/circular_saw,
/obj/machinery/light,
/turf/simulated/floor/plasteel{
	icon_state = "dark"
	},
/area/ruin/unpowered)
"hO" = (
/obj/structure/flora/rock/pile,
/turf/simulated/floor/plating/asteroid,
/area/ruin/unpowered)
"iz" = (
/turf/simulated/floor/plating/airless,
/area/ruin/unpowered)
"iK" = (
/turf/space,
/area/space)
"jf" = (
/obj/structure/window/reinforced{
	dir = 8
	},
/turf/space,
/area/space/nearstation)
"jl" = (
/obj/machinery/shieldwallgen,
/turf/space,
/area/space)
"jK" = (
/obj/structure/grille/broken,
/obj/structure/cable{
	icon_state = "0-8"
	},
/turf/simulated/floor/plating/airless,
/area/ruin/unpowered)
"kQ" = (
/obj/structure/cable{
	icon_state = "4-8"
	},
/obj/machinery/door/airlock/highsecurity{
	name = "Bio Containment";
	req_access = list(47)
	},
/obj/structure/cable{
	icon_state = "2-4"
	},
/turf/simulated/floor/plasteel{
	icon_state = "dark"
	},
/area/ruin/unpowered)
"lc" = (
/obj/machinery/optable,
/turf/simulated/floor/plasteel{
	icon_state = "dark"
	},
/area/ruin/unpowered)
"li" = (
/obj/structure/table/reinforced,
/obj/machinery/computer/med_data/laptop,
/turf/simulated/floor/plasteel{
	icon_state = "dark"
	},
/area/ruin/unpowered)
"lm" = (
/obj/structure/reagent_dispensers/fueltank,
/turf/simulated/floor/plasteel{
	icon_state = "dark"
	},
/area/ruin/unpowered)
"mA" = (
/turf/simulated/floor/plating,
/area/ruin/unpowered)
"mJ" = (
/obj/structure/grille,
/obj/structure/window/full/reinforced,
/obj/structure/cable{
	icon_state = "0-2"
	},
/obj/structure/cable{
	icon_state = "1-2"
	},
/turf/simulated/floor/plating/airless,
/area/ruin/unpowered)
"mM" = (
/obj/machinery/light/small{
	dir = 4
	},
/obj/structure/cable{
	icon_state = "1-2"
	},
/obj/structure/disposalpipe/segment,
/turf/simulated/floor/plasteel{
	icon_state = "dark"
	},
/area/ruin/unpowered)
"ni" = (
/mob/living/simple_animal/hostile/poison/bees,
/mob/living/simple_animal/hostile/poison/bees,
/mob/living/simple_animal/hostile/poison/bees,
/mob/living/simple_animal/hostile/poison/bees,
/mob/living/simple_animal/hostile/poison/bees,
/mob/living/simple_animal/hostile/poison/bees,
/turf/simulated/floor/grass,
/area/ruin/unpowered)
"no" = (
/obj/structure/flora/ausbushes/ppflowers,
/turf/simulated/floor/grass,
/area/ruin/unpowered)
"nz" = (
/obj/structure/chair/office/light{
	dir = 8
	},
/turf/simulated/floor/plasteel,
/area/ruin/unpowered)
"nX" = (
/turf/simulated/mineral,
/area/ruin/unpowered)
"oh" = (
/obj/structure/alien/resin/wall,
/turf/simulated/floor/plating/airless,
/area/ruin/unpowered)
"oo" = (
/obj/structure/alien/weeds/node,
/obj/machinery/light{
	dir = 1
	},
/turf/simulated/floor/plating/airless,
/area/ruin/unpowered)
"oM" = (
/obj/structure/flora/ausbushes/ywflowers,
/turf/simulated/floor/grass,
/area/ruin/unpowered)
"pt" = (
/obj/structure/bed,
/obj/item/bedsheet/green,
/turf/simulated/floor/plasteel{
	icon_state = "dark"
	},
/area/ruin/unpowered)
"qr" = (
/obj/structure/grille,
/obj/structure/window/full/reinforced,
/obj/structure/cable,
/obj/structure/cable{
	icon_state = "1-2"
	},
/obj/structure/disposalpipe/segment,
/turf/simulated/floor/plating/airless,
/area/ruin/unpowered)
"qD" = (
/obj/structure/cable{
	icon_state = "4-8"
	},
/obj/structure/disposalpipe/segment{
	dir = 10
	},
/turf/simulated/floor/plasteel,
/area/ruin/unpowered)
"qZ" = (
/obj/machinery/shieldwallgen{
	anchored = 1
	},
/obj/structure/cable,
/obj/structure/cable{
	icon_state = "1-4"
	},
/turf/simulated/floor/plating/airless,
/area/ruin/unpowered)
"rj" = (
/obj/structure/rack,
/obj/item/crowbar,
/obj/item/shield/riot,
/obj/machinery/light{
	dir = 1
	},
/turf/simulated/floor/plasteel{
	icon_state = "dark"
	},
/area/ruin/unpowered)
"rC" = (
/obj/machinery/space_heater,
/obj/machinery/light{
	dir = 8
	},
/turf/simulated/floor/plasteel{
	icon_state = "dark"
	},
/area/ruin/unpowered)
"rZ" = (
/obj/structure/cable{
	icon_state = "4-8"
	},
/obj/machinery/door/airlock/highsecurity{
	name = "Bio Containment";
	req_access = list(47)
	},
/obj/structure/cable{
	icon_state = "1-8"
	},
/turf/simulated/floor/plasteel{
	icon_state = "dark"
	},
/area/ruin/unpowered)
"se" = (
/obj/machinery/shieldwallgen{
	anchored = 1
	},
/obj/structure/cable{
	icon_state = "1-8"
	},
/obj/structure/cable,
/turf/simulated/floor/plating/airless,
/area/ruin/unpowered)
"tt" = (
/obj/item/stack/cable_coil/cut,
/obj/item/stack/cable_coil/cut,
/obj/item/stack/tile/plasteel{
	pixel_x = 3;
	pixel_y = -4
	},
/obj/item/wirecutters,
/obj/structure/disposalpipe/segment{
	dir = 4
	},
/turf/simulated/floor/plating,
/area/ruin/unpowered)
"tW" = (
/obj/machinery/shieldwallgen{
	anchored = 1
	},
/obj/structure/cable{
	icon_state = "2-4"
	},
/obj/structure/cable{
	icon_state = "0-2"
	},
/turf/simulated/floor/plating/airless,
/area/ruin/unpowered)
"up" = (
/obj/structure/lattice,
/turf/space,
/area/space/nearstation)
"vd" = (
/mob/living/simple_animal/crab/royal{
	faction = list("carp")
	},
/turf/simulated/floor/plating,
/area/ruin/unpowered)
"vl" = (
/obj/structure/cable{
	icon_state = "4-8"
	},
/obj/machinery/door/airlock/highsecurity{
	name = "Bio Containment";
	req_access = list(47)
	},
/obj/structure/cable{
	icon_state = "1-4"
	},
/obj/structure/disposalpipe/segment{
	dir = 5
	},
/turf/simulated/floor/plasteel{
	icon_state = "dark"
	},
/area/ruin/unpowered)
"vS" = (
/obj/machinery/power/apc/worn_out{
	dir = 8;
	pixel_x = -24
	},
/obj/structure/rack,
/obj/item/melee/baton/security/cattleprod,
/obj/effect/spawner/lootdrop/maintenance,
/obj/structure/cable{
	icon_state = "0-2"
	},
/turf/simulated/floor/plasteel{
	icon_state = "dark"
	},
/area/ruin/unpowered)
"wo" = (
/obj/structure/grille,
/obj/structure/window/full/reinforced,
/obj/structure/cable{
	icon_state = "4-8"
	},
/obj/structure/cable{
	icon_state = "0-8"
	},
/turf/simulated/floor/plating/airless,
/area/ruin/unpowered)
"ws" = (
/obj/structure/grille/broken,
/obj/item/shard{
	icon_state = "small"
	},
/obj/structure/cable,
/turf/simulated/floor/plating/airless,
/area/ruin/unpowered)
"wv" = (
/obj/machinery/shieldwallgen{
	anchored = 1
	},
/obj/structure/cable{
	icon_state = "0-8"
	},
/obj/structure/cable{
	icon_state = "2-8"
	},
/turf/simulated/floor/plating/airless,
/area/ruin/unpowered)
"wK" = (
/obj/structure/cable{
	icon_state = "4-8"
	},
/obj/structure/cable{
	icon_state = "1-4"
	},
/obj/structure/disposalpipe/segment{
	dir = 4
	},
/turf/simulated/floor/plasteel,
/area/ruin/unpowered)
"xr" = (
/obj/structure/flora/ausbushes/sunnybush,
/turf/simulated/floor/plating,
/area/ruin/unpowered)
"xB" = (
/obj/structure/cable{
	icon_state = "2-8"
	},
/obj/structure/cable{
	icon_state = "1-8"
	},
/turf/simulated/floor/plasteel{
	icon_state = "dark"
	},
/area/ruin/unpowered)
"xU" = (
/obj/item/shard,
/turf/space,
/area/space)
"yf" = (
/obj/item/gps/ruin,
/turf/simulated/wall/r_wall,
/area/ruin/unpowered)
"yp" = (
/obj/structure/grille,
/obj/structure/window/full/reinforced,
/turf/simulated/floor/plating,
/area/ruin/unpowered)
"yJ" = (
/obj/structure/flora/ausbushes/sparsegrass,
/turf/simulated/floor/plating,
/area/ruin/unpowered)
"zn" = (
/obj/structure/cable{
	icon_state = "2-4"
	},
/obj/structure/cable{
	icon_state = "1-4"
	},
/obj/structure/disposalpipe/segment{
	dir = 6
	},
/turf/simulated/floor/plasteel{
	icon_state = "dark"
	},
/area/ruin/unpowered)
"Ap" = (
/obj/structure/cable{
	icon_state = "1-2"
	},
/obj/structure/disposalpipe/segment,
/turf/simulated/floor/plasteel{
	icon_state = "dark"
	},
/area/ruin/unpowered)
"Ax" = (
/obj/machinery/shieldwallgen{
	anchored = 1
	},
/obj/structure/cable{
	icon_state = "0-4"
	},
/obj/structure/cable{
	icon_state = "2-4"
	},
/turf/simulated/floor/plating/airless,
/area/ruin/unpowered)
"AE" = (
/mob/living/simple_animal/hostile/asteroid/goldgrub{
	will_burrow = 0
	},
/turf/simulated/floor/plating/asteroid,
/area/ruin/unpowered)
"AU" = (
/obj/structure/table/reinforced,
/obj/item/gun/syringe,
/turf/simulated/floor/plasteel{
	icon_state = "dark"
	},
/area/ruin/unpowered)
"Bz" = (
/obj/structure/window/reinforced{
	dir = 4
	},
/turf/space,
/area/space/nearstation)
"BI" = (
/obj/structure/grille,
/obj/structure/window/full/reinforced,
/obj/structure/cable,
/obj/structure/cable{
	icon_state = "1-2"
	},
/obj/structure/disposalpipe/segment{
	dir = 5
	},
/turf/simulated/floor/plating/airless,
/area/ruin/unpowered)
"BS" = (
/obj/structure/grille,
/obj/structure/window/full/reinforced,
/obj/structure/cable{
	icon_state = "4-8"
	},
/obj/structure/cable{
	icon_state = "0-4"
	},
/turf/simulated/floor/plating/airless,
/area/ruin/unpowered)
"Dk" = (
/obj/machinery/shieldwallgen{
	anchored = 1
	},
/obj/structure/cable{
	icon_state = "0-8"
	},
/obj/structure/cable{
	icon_state = "1-8"
	},
/turf/simulated/floor/plating/airless,
/area/ruin/unpowered)
"Ds" = (
/obj/structure/table/reinforced,
/obj/item/gun/energy/temperature,
/turf/simulated/floor/plasteel{
	icon_state = "dark"
	},
/area/ruin/unpowered)
"Du" = (
/obj/structure/alien/weeds,
/turf/simulated/floor/plating/airless,
/area/ruin/unpowered)
"Ec" = (
/obj/structure/disposalpipe/trunk{
	dir = 1
	},
/obj/structure/disposaloutlet,
/turf/simulated/floor/plating/airless,
/area/space/nearstation)
"Fo" = (
/obj/machinery/light/small{
	dir = 4
	},
/obj/structure/cable{
	icon_state = "1-2"
	},
/turf/simulated/floor/plasteel{
	icon_state = "dark"
	},
/area/ruin/unpowered)
"FB" = (
/obj/structure/closet/wardrobe/toxins_white,
/turf/simulated/floor/plasteel{
	icon_state = "dark"
	},
/area/ruin/unpowered)
"FD" = (
/obj/structure/grille,
/obj/structure/window/full/reinforced,
/obj/structure/cable{
	icon_state = "4-8"
	},
/turf/simulated/floor/plating/airless,
/area/ruin/unpowered)
"FL" = (
/obj/structure/disposalpipe/segment{
	dir = 10
	},
/turf/simulated/floor/plating/airless,
/area/space/nearstation)
"Gx" = (
/obj/item/clothing/mask/facehugger{
	icon_state = "facehugger_dead";
	stat = 2
	},
/turf/simulated/floor/plating/airless,
/area/ruin/unpowered)
"GZ" = (
/obj/structure/table/reinforced,
/obj/item/folder,
/turf/simulated/floor/plasteel{
	icon_state = "dark"
	},
/area/ruin/unpowered)
"Hp" = (
/obj/structure/grille,
/obj/structure/window/full/reinforced,
/obj/structure/cable{
	icon_state = "0-2"
	},
/turf/simulated/floor/plating/airless,
/area/ruin/unpowered)
"Hz" = (
/obj/machinery/shieldwallgen{
	anchored = 1
	},
/obj/structure/cable{
	icon_state = "0-8"
	},
/obj/structure/cable{
	icon_state = "2-8"
	},
/obj/structure/disposalpipe/segment{
	dir = 10
	},
/turf/simulated/floor/plating/airless,
/area/ruin/unpowered)
"HU" = (
/obj/structure/flora/ausbushes/reedbush,
/turf/simulated/floor/plating,
/area/ruin/unpowered)
"Ic" = (
/turf/simulated/floor/plating/asteroid,
/area/ruin/unpowered)
"Ja" = (
/obj/structure/table/reinforced,
/obj/item/clipboard,
/obj/item/clothing/mask/surgical,
/obj/item/razor,
/obj/machinery/light{
	dir = 8
	},
/turf/simulated/floor/plasteel{
	icon_state = "dark"
	},
/area/ruin/unpowered)
"Jb" = (
/obj/structure/table/reinforced,
/obj/item/reagent_containers/hypospray/autoinjector/stimpack,
/obj/item/reagent_containers/glass/bottle/mutagen,
/turf/simulated/floor/plasteel{
	icon_state = "dark"
	},
/area/ruin/unpowered)
"JH" = (
/obj/structure/reagent_dispensers/watertank,
/obj/machinery/light,
/turf/simulated/floor/plasteel{
	icon_state = "dark"
	},
/area/ruin/unpowered)
"JO" = (
/obj/machinery/power/terminal,
/obj/structure/cable,
/turf/simulated/floor/plating,
/area/ruin/unpowered)
"JU" = (
/obj/structure/flora/ausbushes/palebush,
/turf/simulated/floor/plating,
/area/ruin/unpowered)
"Km" = (
/obj/machinery/door/airlock/hatch{
	name = "Bio-Research Station"
	},
/turf/simulated/floor/plasteel,
/area/ruin/unpowered)
"Lg" = (
/obj/machinery/computer/operating,
/turf/simulated/floor/plasteel{
	icon_state = "dark"
	},
/area/ruin/unpowered)
"LT" = (
/obj/structure/cable{
	icon_state = "4-8"
	},
/turf/simulated/floor/plasteel,
/area/ruin/unpowered)
"LU" = (
/turf/simulated/floor/plasteel,
/area/ruin/unpowered)
"Mf" = (
/obj/machinery/light/small{
	dir = 8
	},
/obj/structure/cable{
	icon_state = "1-2"
	},
/turf/simulated/floor/plasteel{
	icon_state = "dark"
	},
/area/ruin/unpowered)
"MH" = (
/obj/structure/flora/ausbushes/lavendergrass,
/turf/simulated/floor/grass,
/area/ruin/unpowered)
"MK" = (
/obj/structure/table/reinforced,
/obj/item/cultivator,
/obj/item/shovel,
/turf/simulated/floor/plasteel{
	icon_state = "dark"
	},
/area/ruin/unpowered)
"Nd" = (
/obj/machinery/power/smes/magical{
	desc = "A high-capacity superconducting magnetic energy storage (SMES) unit.";
	name = "power storage unit"
	},
/obj/structure/cable,
/turf/simulated/floor/plasteel{
	icon_state = "dark"
	},
/area/ruin/unpowered)
"NY" = (
/obj/structure/flora/ausbushes/grassybush,
/turf/simulated/floor/grass,
/area/ruin/unpowered)
"Oi" = (
/mob/living/simple_animal/hostile/poison/bees,
/turf/simulated/floor/grass,
/area/ruin/unpowered)
"OF" = (
/obj/machinery/light/small{
	dir = 4
	},
/turf/simulated/floor/plasteel,
/area/ruin/unpowered)
"Qe" = (
/obj/machinery/light/small{
	dir = 8
	},
/turf/simulated/floor/plasteel,
/area/ruin/unpowered)
"QK" = (
/obj/structure/flora/ausbushes/brflowers,
/turf/simulated/floor/grass,
/area/ruin/unpowered)
"QQ" = (
/obj/structure/rack,
/obj/item/clothing/suit/space/hardsuit/medical,
/obj/item/tank/internals/emergency_oxygen/double,
/turf/simulated/floor/plasteel{
	icon_state = "dark"
	},
/area/ruin/unpowered)
"Rf" = (
/obj/structure/table/reinforced,
/obj/item/reagent_containers/food/snacks/carrotfries,
/turf/simulated/floor/plasteel{
	icon_state = "dark"
	},
/area/ruin/unpowered)
"Rk" = (
/obj/structure/flora/ausbushes/genericbush,
/turf/simulated/floor/grass,
/area/ruin/unpowered)
"RV" = (
/turf/template_noop,
/area/template_noop)
"RZ" = (
/obj/item/shard,
/turf/simulated/floor/plating/airless,
/area/ruin/unpowered)
"SA" = (
/obj/machinery/shieldwallgen{
	anchored = 1
	},
/obj/structure/cable{
	icon_state = "0-2"
	},
/obj/structure/cable{
	icon_state = "2-4"
	},
/turf/simulated/floor/plating/airless,
/area/ruin/unpowered)
"SO" = (
/obj/machinery/light{
	dir = 1
	},
/mob/living/simple_animal/hostile/carp,
/turf/simulated/floor/plating,
/area/ruin/unpowered)
"SP" = (
/obj/machinery/door/airlock/external,
/turf/simulated/floor/plasteel,
/area/ruin/unpowered)
"Tc" = (
/obj/machinery/shieldwallgen{
	anchored = 1
	},
/obj/structure/cable{
	icon_state = "1-8"
	},
/obj/structure/cable{
	icon_state = "0-8"
	},
/turf/simulated/floor/plating/airless,
/area/ruin/unpowered)
"Tf" = (
/obj/structure/cable{
	icon_state = "4-8"
	},
/obj/machinery/door/airlock/highsecurity{
	name = "Bio Containment";
	req_access = list(47)
	},
/obj/structure/cable{
	icon_state = "2-8"
	},
/turf/simulated/floor/plasteel{
	icon_state = "dark"
	},
/area/ruin/unpowered)
"TD" = (
/obj/machinery/shieldwallgen{
	anchored = 1
	},
/obj/structure/cable{
	icon_state = "0-4"
	},
/obj/structure/cable{
	icon_state = "1-4"
	},
/turf/simulated/floor/plating/airless,
/area/ruin/unpowered)
"TG" = (
/obj/machinery/door/airlock/hatch{
	name = "Bio-Research Station"
	},
/obj/structure/cable{
	icon_state = "4-8"
	},
/obj/structure/disposalpipe/segment{
	dir = 4
	},
/turf/simulated/floor/plasteel,
/area/ruin/unpowered)
"Ud" = (
/obj/structure/table/reinforced,
/obj/machinery/kitchen_machine/microwave,
/turf/simulated/floor/plasteel{
	icon_state = "dark"
	},
/area/ruin/unpowered)
"Uv" = (
/obj/structure/table/reinforced,
/obj/item/grenade/chem_grenade/antiweed{
	pixel_x = 3;
	pixel_y = 5
	},
/obj/item/grenade/chem_grenade/antiweed{
	pixel_x = 4
	},
/obj/item/grenade/chem_grenade/antiweed{
	pixel_x = -3;
	pixel_y = -1
	},
/obj/machinery/light{
	dir = 1
	},
/turf/simulated/floor/plasteel{
	icon_state = "dark"
	},
/area/ruin/unpowered)
"UA" = (
/obj/structure/grille,
/obj/structure/window/full/reinforced,
/obj/structure/cable,
/obj/structure/cable{
	icon_state = "1-2"
	},
/turf/simulated/floor/plating/airless,
/area/ruin/unpowered)
"VI" = (
/obj/structure/cable{
	icon_state = "4-8"
	},
/obj/structure/disposalpipe/segment{
	dir = 4
	},
/turf/simulated/floor/plasteel,
/area/ruin/unpowered)
"VN" = (
/obj/structure/table/reinforced,
/obj/machinery/juicer,
/turf/simulated/floor/plasteel{
	icon_state = "dark"
	},
/area/ruin/unpowered)
"Wq" = (
/turf/simulated/wall/r_wall,
/area/ruin/unpowered)
"Wv" = (
/obj/structure/disposalpipe/segment,
/turf/simulated/floor/plasteel,
/area/ruin/unpowered)
"Xg" = (
/obj/structure/table/reinforced,
/obj/item/reagent_containers/glass/bottle/liver_enhance_virion,
/obj/item/reagent_containers/dropper,
/turf/simulated/floor/plasteel{
	icon_state = "dark"
	},
/area/ruin/unpowered)
"Xh" = (
/obj/machinery/door/airlock/hatch{
	name = "Bio-Research Station"
	},
/obj/structure/cable{
	icon_state = "4-8"
	},
/turf/simulated/floor/plasteel,
/area/ruin/unpowered)
"Yk" = (
/obj/structure/grille,
/obj/structure/window/full/reinforced,
/obj/structure/cable{
	icon_state = "1-2"
	},
/obj/structure/cable,
/turf/simulated/floor/plating/airless,
/area/ruin/unpowered)
"Yv" = (
/obj/structure/flora/rock,
/turf/simulated/floor/plating/asteroid,
/area/ruin/unpowered)
"Zn" = (
/obj/structure/cable{
	icon_state = "1-4"
	},
/obj/structure/cable,
/obj/machinery/shieldwallgen{
	anchored = 1
	},
/turf/simulated/floor/plating/airless,
/area/ruin/unpowered)
"ZT" = (
/obj/structure/table/reinforced,
/obj/item/gun/energy/floragun,
/turf/simulated/floor/plasteel{
	icon_state = "dark"
	},
/area/ruin/unpowered)

(1,1,1) = {"
RV
RV
RV
RV
RV
RV
RV
RV
RV
RV
RV
RV
RV
RV
RV
RV
RV
RV
RV
RV
RV
RV
"}
(2,1,1) = {"
RV
iK
iK
iK
iK
iK
iK
iK
iK
iK
iK
iK
iK
iK
iK
iK
iK
iK
iK
iK
iK
RV
"}
(3,1,1) = {"
RV
iK
SA
mJ
mJ
mJ
mJ
TD
iK
iK
iK
iK
iK
iK
Ax
UA
UA
UA
UA
qZ
iK
RV
"}
(4,1,1) = {"
RV
iK
wo
nX
Ic
hO
nX
BS
Bz
Bz
Bz
Bz
Bz
Bz
FD
xr
mA
HU
mA
wo
iK
RV
"}
(5,1,1) = {"
RV
iK
wo
nX
AE
Ic
Ic
kQ
dx
Fo
zn
Ap
mM
Ap
vl
mA
mA
vd
mA
wo
iK
RV
"}
(6,1,1) = {"
RV
iK
BS
Ic
nX
Ic
dr
wo
Wq
Wq
TG
Km
Wq
Wq
gb
SO
mA
mA
mA
BS
iK
RV
"}
(7,1,1) = {"
RV
iK
BS
Yv
Ic
ax
hO
wo
Wq
vS
wK
LU
lm
Wq
gb
JU
yJ
mA
mA
BS
iK
RV
"}
(8,1,1) = {"
RV
iK
fg
Hp
Hp
Hp
Hp
Dk
Wq
QQ
tt
JO
Nd
Wq
Hz
qr
qr
BI
UA
se
iK
RV
"}
(9,1,1) = {"
RV
iK
iK
iK
iK
Wq
Wq
Wq
yf
rj
VI
LU
JH
Wq
Wq
Wq
Wq
FL
go
Ec
iK
RV
"}
(10,1,1) = {"
RV
iK
iK
iK
iK
yp
Ja
ZT
GZ
eM
qD
Wv
fT
FB
pt
rC
Wq
Wq
Wq
iK
iK
RV
"}
(11,1,1) = {"
RV
iK
iK
iK
iK
yp
LU
LU
nz
LU
LT
LU
LU
LU
LU
LU
SP
Qe
SP
iK
iK
RV
"}
(12,1,1) = {"
RV
iK
iK
iK
iK
yp
LU
LU
LU
LU
LT
LU
LU
LU
LU
LU
SP
OF
SP
iK
iK
RV
"}
(13,1,1) = {"
RV
iK
iK
iK
iK
yp
bq
li
Xg
AU
LT
LU
Jb
Rf
Ud
VN
Wq
Wq
Wq
iK
iK
RV
"}
(14,1,1) = {"
RV
iK
iK
iK
iK
Wq
Wq
Wq
Wq
Uv
LT
LU
hh
Wq
Wq
Wq
Wq
iK
iK
iK
iK
RV
"}
(15,1,1) = {"
RV
iK
tW
es
es
es
es
TD
Wq
Ds
LT
LU
lc
Wq
Ax
Yk
Yk
Yk
Yk
Zn
iK
RV
"}
(16,1,1) = {"
RV
iK
wo
Rk
Oi
Oi
oM
BS
Wq
MK
LT
LU
Lg
Wq
BS
Du
Du
Gx
oh
wo
iK
RV
"}
(17,1,1) = {"
RV
iK
wo
ni
ni
MH
fX
BS
Wq
Wq
Xh
Km
Wq
Wq
BS
oo
oh
oh
iz
dm
iK
RV
"}
(18,1,1) = {"
RV
iK
BS
Oi
NY
gp
ni
Tf
dx
Mf
xB
dx
Mf
dx
rZ
Gx
Du
iz
RZ
jK
xU
RV
"}
(19,1,1) = {"
RV
iK
BS
MH
Oi
QK
no
wo
jf
jf
jf
jf
jf
jf
wo
Du
Du
iz
iz
up
iK
RV
"}
(20,1,1) = {"
RV
iK
fg
mJ
mJ
mJ
mJ
Tc
iK
iK
iK
iK
iK
iK
wv
Yk
Yk
ws
up
iK
iK
RV
"}
(21,1,1) = {"
RV
iK
iK
iK
iK
iK
iK
iK
iK
iK
iK
iK
iK
iK
iK
iK
iK
iK
iK
jl
iK
RV
"}
(22,1,1) = {"
RV
RV
RV
RV
RV
RV
RV
RV
RV
RV
RV
RV
RV
RV
RV
RV
RV
RV
RV
RV
RV
RV
"}
