//MAP CONVERTED BY dmm2tgm.py THIS HEADER COMMENT PREVENTS RECONVERSION, DO NOT REMOVE
"a" = (
/turf/template_noop,
/area/template_noop)
"b" = (
/turf/simulated/floor/plating/asteroid/airless,
/area/ruin/unpowered)
"d" = (
/turf/simulated/mineral/random/high_chance,
/area/ruin/unpowered)
"e" = (
/obj/effect/decal/remains/human,
/turf/simulated/floor/plating/asteroid/airless,
/area/ruin/unpowered)
"f" = (
/obj/item/pickaxe/diamond,
/turf/simulated/floor/plating/asteroid/airless,
/area/ruin/unpowered)

(1,1,1) = {"
a
a
a
a
b
a
a
a
a
a
b
d
d
d
d
b
a
a
a
a
"}
(2,1,1) = {"
a
a
a
a
a
a
a
a
a
b
b
d
d
d
d
d
d
d
a
a
"}
(3,1,1) = {"
a
a
b
b
a
b
b
b
a
b
b
d
d
d
d
d
d
d
b
a
"}
(4,1,1) = {"
a
a
b
b
b
b
d
d
b
b
d
d
d
d
d
d
d
d
b
a
"}
(5,1,1) = {"
a
a
b
b
d
d
d
d
d
d
d
d
d
d
d
d
d
d
d
a
"}
(6,1,1) = {"
a
a
a
b
d
d
d
d
d
d
d
d
b
d
d
d
d
d
b
a
"}
(7,1,1) = {"
a
a
a
a
b
b
d
d
d
d
b
b
b
b
d
d
d
d
b
a
"}
(8,1,1) = {"
a
a
a
b
b
d
d
d
d
b
b
b
f
b
b
d
d
b
b
b
"}
(9,1,1) = {"
a
a
a
b
b
d
d
d
d
b
b
e
b
b
b
d
d
d
b
b
"}
(10,1,1) = {"
a
a
a
b
b
d
d
b
b
b
b
b
b
b
d
d
d
d
d
b
"}
(11,1,1) = {"
a
a
a
b
b
d
d
d
d
d
b
b
d
d
d
d
d
d
b
b
"}
(12,1,1) = {"
a
a
a
a
b
d
d
d
d
d
d
d
d
d
d
d
d
d
b
b
"}
(13,1,1) = {"
a
a
a
a
b
d
d
d
d
d
d
d
d
d
d
d
d
b
b
a
"}
(14,1,1) = {"
a
a
a
a
b
d
d
d
d
d
d
d
d
d
d
b
b
b
a
a
"}
(15,1,1) = {"
a
a
b
a
b
d
d
d
d
d
d
d
d
d
d
b
a
a
a
b
"}
(16,1,1) = {"
a
a
a
a
b
b
b
d
d
d
d
d
d
b
b
a
a
a
a
a
"}
(17,1,1) = {"
a
a
a
a
a
b
b
d
d
d
d
d
d
b
b
a
a
a
a
a
"}
(18,1,1) = {"
a
a
a
a
a
a
a
a
d
d
d
a
a
a
a
a
a
a
a
a
"}
(19,1,1) = {"
a
a
a
a
b
a
a
a
a
a
a
a
a
a
b
a
a
a
b
a
"}
(20,1,1) = {"
a
a
a
a
a
a
a
a
a
a
a
a
a
a
a
a
a
a
a
a
"}
