//MAP CONVERTED BY dmm2tgm.py THIS HEADER COMMENT PREVENTS RECONVERSION, DO NOT REMOVE
"aP" = (
/obj/item/trash/tastybread,
/turf/simulated/floor/wood/fancy/birch,
/area/ruin/astroak)
"bV" = (
/obj/structure/bed,
/obj/item/bedsheet/wiz,
/obj/effect/decal/cleanable/blood,
/obj/effect/decal/remains/human,
/turf/simulated/floor/wood/fancy/birch,
/area/ruin/astroak)
"cD" = (
/obj/structure/sign/holy,
/turf/simulated/wall/mineral/wood/nonmetal,
/area/ruin/astroak)
"cH" = (
/obj/structure/window/reinforced/survival_pod{
	dir = 6;
	name = "window"
	},
/turf/simulated/floor/grass,
/area/ruin/astroak)
"dw" = (
/obj/effect/decal/cleanable/blood/writing{
	dir = 4
	},
/obj/effect/rune,
/turf/simulated/floor/engine/cult,
/area/ruin/astroak)
"eH" = (
/obj/structure/bookcase/random/religion,
/turf/simulated/floor/wood/fancy/birch,
/area/ruin/astroak)
"eJ" = (
/obj/structure/window/reinforced/survival_pod{
	name = "window";
	dir = 4
	},
/turf/simulated/floor/grass,
/area/ruin/astroak)
"eM" = (
/obj/structure/mineral_door/wood,
/obj/structure/barricade/wooden/crude,
/turf/simulated/floor/wood/fancy/birch,
/area/ruin/astroak)
"fM" = (
/obj/structure/sign/poster/official/tsf_emblem,
/turf/simulated/wall/mineral/wood,
/area/ruin/astroak)
"fW" = (
/obj/structure/window/reinforced/survival_pod{
	name = "window";
	dir = 4
	},
/obj/structure/window/reinforced/survival_pod{
	name = "window";
	dir = 2
	},
/turf/simulated/floor/grass,
/area/ruin/astroak)
"gl" = (
/obj/item/stack/sheet/wood,
/turf/simulated/floor/wood/fancy/birch,
/area/ruin/astroak)
"gy" = (
/obj/structure/flora/grass/jungle,
/turf/simulated/floor/grass,
/area/ruin/astroak)
"gE" = (
/obj/item/melee/cultblade,
/turf/simulated/floor/engine/cult,
/area/ruin/astroak)
"gJ" = (
/obj/structure/window/reinforced/survival_pod{
	name = "window";
	dir = 2
	},
/turf/simulated/floor/grass,
/area/ruin/astroak)
"gK" = (
/obj/structure/sacrificealtar,
/turf/simulated/floor/wood/fancy/birch,
/area/ruin/astroak)
"hC" = (
/obj/structure/cult/archives,
/turf/simulated/floor/engine/cult,
/area/ruin/astroak)
"kz" = (
/obj/structure/mineral_door/wood,
/turf/simulated/floor/wood/birch,
/area/ruin/astroak)
"lt" = (
/obj/item/trash/candle{
	pixel_y = 11
	},
/turf/simulated/floor/wood/fancy/birch,
/area/ruin/astroak)
"ly" = (
/obj/item/restraints/legcuffs/bola/cult,
/turf/simulated/floor/engine/cult,
/area/ruin/astroak)
"lA" = (
/obj/structure/cult/altar,
/obj/item/book_of_babel,
/turf/simulated/floor/engine/cult,
/area/ruin/astroak)
"mw" = (
/obj/structure/closet,
/obj/item/stack/sheet/runed_metal_fake,
/turf/simulated/floor/engine/cult,
/area/ruin/astroak)
"mM" = (
/obj/effect/decal/cleanable/blood/gibs/old,
/turf/simulated/floor/wood/fancy/birch,
/area/ruin/astroak)
"ne" = (
/obj/structure/sign/poster/ripped,
/turf/simulated/wall/mineral/wood,
/area/ruin/astroak)
"nG" = (
/obj/structure/cult/archives,
/obj/item/clothing/suit/space/cult,
/turf/simulated/floor/engine/cult,
/area/ruin/astroak)
"nL" = (
/obj/structure/table_frame/wood,
/turf/simulated/floor/wood/fancy/birch,
/area/ruin/astroak)
"nO" = (
/obj/effect/decal/cleanable/blood/old,
/turf/simulated/floor/wood/fancy/birch,
/area/ruin/astroak)
"oi" = (
/obj/structure/mineral_door/wood,
/turf/simulated/floor/wood/fancy/birch,
/area/ruin/astroak)
"oY" = (
/obj/item/flashlight/lantern,
/turf/simulated/floor/wood/fancy/birch,
/area/ruin/astroak)
"pq" = (
/obj/effect/decal/cleanable/blood/old,
/obj/item/flag/cult,
/turf/simulated/floor/wood/fancy/birch,
/area/ruin/astroak)
"pB" = (
/obj/structure/closet/crate/trashcart/gibs,
/turf/simulated/floor/engine/cult,
/area/ruin/astroak)
"qF" = (
/obj/effect/decal/cleanable/blood/writing,
/turf/simulated/floor/wood/fancy/birch,
/area/ruin/astroak)
"qO" = (
/mob/living/simple_animal/hostile/illusion/cult{
	deathmessage = "disappears into the air with a cry of agony";
	desc = "The deceived soul";
	health = 200;
	maxHealth = 350;
	name = "The soul of the cultist";
	icon = 'icons/mob/mob.dmi';
	icon_living = "shade";
	icon_state = "shade";
	icon_dead = "shade_dead";
	melee_damage_lower = 10;
	melee_damage_upper = 25
	},
/turf/simulated/floor/engine/cult,
/area/ruin/astroak)
"rb" = (
/obj/item/fish_eggs/babycarp,
/obj/item/shard,
/turf/simulated/floor/wood/fancy/birch,
/area/ruin/astroak)
"rD" = (
/obj/structure/wooden_sign{
	desc = "Астроак открыт для посещения";
	name = "Астроак"
	},
/turf/simulated/floor/grass,
/area/ruin/astroak)
"sF" = (
/obj/item/toy/sword,
/turf/simulated/floor/wood/fancy/birch,
/area/ruin/astroak)
"sT" = (
/obj/structure/sacrificealtar,
/obj/item/nullrod/carp,
/turf/simulated/floor/wood/fancy/birch,
/area/ruin/astroak)
"sX" = (
/turf/simulated/wall/mineral/wood,
/area/ruin/astroak)
"tE" = (
/obj/structure/noticeboard,
/turf/simulated/wall/mineral/wood,
/area/ruin/astroak)
"tR" = (
/turf/space,
/area/ruin/astroak)
"uI" = (
/obj/structure/window/reinforced/survival_pod{
	dir = 8;
	name = "window"
	},
/turf/simulated/floor/grass,
/area/ruin/astroak)
"uJ" = (
/obj/structure/table/wood/fancy/red,
/obj/item/toy/carpplushie/ice,
/turf/simulated/floor/wood/fancy/birch,
/area/ruin/astroak)
"wh" = (
/obj/effect/decal/cleanable/blood/writing,
/turf/simulated/floor/engine/cult,
/area/ruin/astroak)
"wk" = (
/mob/living/simple_animal/hostile/carp/mcarp,
/turf/simulated/floor/wood/fancy/birch,
/area/ruin/astroak)
"wU" = (
/obj/structure/window/full/paperframe,
/obj/structure/curtain/open/shower/security,
/turf/simulated/floor/wood/birch,
/area/ruin/astroak)
"yF" = (
/turf/simulated/wall/mineral/wood/nonmetal,
/area/ruin/astroak)
"yT" = (
/obj/structure/window/reinforced/survival_pod{
	name = "window";
	dir = 4
	},
/turf/space,
/area/space)
"zb" = (
/mob/living/simple_animal/hostile/carp,
/turf/space,
/area/space)
"zg" = (
/obj/item/trash/candle,
/turf/simulated/floor/wood/fancy/birch,
/area/ruin/astroak)
"zC" = (
/obj/item/trash/candle{
	pixel_y = 13
	},
/turf/simulated/floor/wood/fancy/birch,
/area/ruin/astroak)
"zK" = (
/obj/item/flag/cult,
/obj/effect/decal/cleanable/blood/gibs/old,
/turf/simulated/floor/wood/fancy/birch,
/area/ruin/astroak)
"zN" = (
/obj/structure/cult/altar,
/obj/item/tome,
/turf/simulated/floor/engine/cult,
/area/ruin/astroak)
"zR" = (
/turf/simulated/floor/grass,
/area/ruin/astroak)
"Af" = (
/obj/structure/window/reinforced/survival_pod{
	name = "window";
	dir = 2
	},
/obj/structure/flora/grass/jungle,
/turf/simulated/floor/grass,
/area/ruin/astroak)
"Av" = (
/obj/item/chair/wood,
/mob/living/simple_animal/hostile/carp/mcarp,
/turf/simulated/floor/wood/fancy/birch,
/area/ruin/astroak)
"Be" = (
/obj/structure/bed,
/obj/item/bedsheet/fluff/hugosheet,
/turf/simulated/floor/wood/fancy/birch,
/area/ruin/astroak)
"Bi" = (
/obj/item/melee/cultblade/dagger,
/turf/simulated/floor/engine/cult,
/area/ruin/astroak)
"Bj" = (
/obj/structure/window/reinforced/survival_pod{
	name = "window";
	dir = 2
	},
/obj/structure/window/reinforced/survival_pod{
	name = "window";
	dir = 4
	},
/turf/simulated/floor/grass,
/area/ruin/astroak)
"BG" = (
/obj/structure/window/reinforced/survival_pod{
	name = "window";
	dir = 10
	},
/obj/structure/window/reinforced/survival_pod{
	name = "window";
	dir = 9
	},
/obj/structure/window/reinforced/survival_pod{
	dir = 8;
	name = "window"
	},
/turf/simulated/floor/grass,
/area/ruin/astroak)
"BY" = (
/obj/structure/sign/poster/contraband/very_robust,
/turf/simulated/wall/cult,
/area/ruin/astroak)
"DC" = (
/obj/item/trash/candle,
/obj/effect/decal/cleanable/blood/writing{
	dir = 4
	},
/turf/simulated/floor/wood/fancy/birch,
/area/ruin/astroak)
"DN" = (
/obj/structure/closet/crate,
/obj/item/pickaxe/diamond,
/obj/item/pickaxe/diamond,
/turf/simulated/floor/grass,
/area/ruin/astroak)
"DP" = (
/obj/item/trash/candy,
/turf/simulated/floor/wood/fancy/birch,
/area/ruin/astroak)
"DS" = (
/obj/structure/sign/poster/contraband/wanted,
/turf/simulated/wall/mineral/wood,
/area/ruin/astroak)
"DX" = (
/obj/item/shield/riot/buckler,
/turf/simulated/floor/wood/fancy/birch,
/area/ruin/astroak)
"Eg" = (
/turf/simulated/wall/indestructible/rock/dark,
/area/ruin/astroak)
"ED" = (
/obj/effect/decal/cleanable/glass/plasma,
/obj/structure/window/reinforced{
	dir = 8
	},
/obj/item/reagent_containers/glass/bucket/wooden,
/turf/simulated/floor/wood/fancy/birch,
/area/ruin/astroak)
"EW" = (
/obj/effect/decal/cleanable/blood/writing{
	dir = 4
	},
/turf/simulated/floor/wood/fancy/birch,
/area/ruin/astroak)
"EX" = (
/obj/effect/decal/cleanable/blood/gibs/old,
/obj/item/holder/narsian{
	name = "Nar'SIe Corgi"
	},
/turf/simulated/floor/wood/fancy/birch,
/area/ruin/astroak)
"FE" = (
/obj/structure/statue/carp_mini{
	pixel_y = 16
	},
/obj/structure/table/wood/fancy/red,
/turf/simulated/floor/wood/fancy/birch,
/area/ruin/astroak)
"Ga" = (
/obj/structure/flora/tree/dead,
/turf/simulated/floor/grass,
/area/ruin/astroak)
"Ge" = (
/obj/structure/cult/pylon,
/turf/simulated/floor/engine/cult,
/area/ruin/astroak)
"GG" = (
/obj/structure/curtain/open/shower/security,
/obj/structure/mineral_door/wood,
/turf/simulated/floor/wood/fancy/birch,
/area/ruin/astroak)
"GI" = (
/obj/effect/decal/remains/human,
/turf/simulated/floor/wood/fancy/birch,
/area/ruin/astroak)
"GL" = (
/obj/effect/decal/cleanable/blood,
/turf/simulated/floor/wood/fancy/birch,
/area/ruin/astroak)
"GT" = (
/turf/simulated/floor/indestructible/beach/water/deep/dense,
/area/ruin/astroak)
"Hb" = (
/obj/effect/decal/cleanable/glass/plasma,
/obj/structure/window/reinforced{
	dir = 8
	},
/turf/simulated/floor/wood/fancy/birch,
/area/ruin/astroak)
"Hc" = (
/obj/structure/flora/ausbushes/sparsegrass,
/obj/structure/window/reinforced/survival_pod{
	name = "window";
	dir = 10
	},
/turf/simulated/floor/grass,
/area/ruin/astroak)
"Hd" = (
/obj/item/reagent_containers/food/drinks/bottle/unholywater,
/turf/simulated/floor/wood/fancy/birch,
/area/ruin/astroak)
"HE" = (
/obj/structure/closet,
/turf/simulated/floor/wood/fancy/birch,
/area/ruin/astroak)
"HL" = (
/obj/structure/cult/forge,
/turf/simulated/floor/engine/cult,
/area/ruin/astroak)
"Ih" = (
/obj/structure/window/reinforced/survival_pod{
	name = "window";
	dir = 2
	},
/obj/structure/window/reinforced/survival_pod{
	name = "window";
	dir = 2
	},
/obj/structure/window/reinforced/survival_pod{
	name = "window";
	dir = 4
	},
/turf/simulated/floor/grass,
/area/ruin/astroak)
"Ii" = (
/turf/simulated/floor/engine/cult,
/area/ruin/astroak)
"It" = (
/obj/structure/flora/ausbushes/sparsegrass,
/obj/structure/window/reinforced/survival_pod{
	name = "window";
	dir = 2
	},
/turf/simulated/floor/grass,
/area/ruin/astroak)
"Jf" = (
/obj/item/reagent_containers/glass/bucket/wooden,
/turf/simulated/floor/wood/fancy/birch,
/area/ruin/astroak)
"Ky" = (
/obj/structure/flora/ausbushes/sparsegrass,
/turf/simulated/floor/grass,
/area/ruin/astroak)
"KJ" = (
/turf/simulated/floor/wood/fancy/birch,
/area/ruin/astroak)
"Lr" = (
/obj/machinery/shield/cult/barrier,
/turf/simulated/floor/engine/cult,
/area/ruin/astroak)
"LX" = (
/obj/machinery/door/window/survival_pod{
	dir = 8
	},
/turf/simulated/floor/grass,
/area/ruin/astroak)
"Md" = (
/turf/simulated/floor/plating/asteroid/airless,
/area/ruin/astroak)
"MC" = (
/obj/structure/decorative_structures/corpse,
/turf/simulated/floor/wood/fancy/birch,
/area/ruin/astroak)
"Ni" = (
/obj/structure/bed,
/obj/item/bedsheet/cult,
/turf/simulated/floor/wood/fancy/birch,
/area/ruin/astroak)
"Np" = (
/obj/structure/sign/poster/official/religious,
/turf/simulated/wall/mineral/wood/nonmetal,
/area/ruin/astroak)
"Nw" = (
/obj/structure/window/reinforced/survival_pod{
	name = "window";
	dir = 9
	},
/turf/simulated/floor/grass,
/area/ruin/astroak)
"NL" = (
/obj/structure/table/wood/fancy/red,
/obj/item/toy/carpplushie/nebula,
/turf/simulated/floor/wood/fancy/birch,
/area/ruin/astroak)
"OQ" = (
/obj/structure/table/wood/fancy,
/obj/item/storage/fancy/cigarettes/cigpack_carp,
/turf/simulated/floor/wood/fancy/birch,
/area/ruin/astroak)
"OV" = (
/obj/structure/table/wood/fancy/red,
/turf/simulated/floor/wood/fancy/birch,
/area/ruin/astroak)
"Py" = (
/obj/item/trash/chips,
/turf/simulated/floor/wood/fancy/birch,
/area/ruin/astroak)
"PM" = (
/turf/space,
/area/space)
"Qw" = (
/obj/effect/decal/cleanable/blood/old,
/turf/simulated/floor/engine/cult,
/area/ruin/astroak)
"QD" = (
/obj/structure/window/reinforced/survival_pod{
	dir = 6;
	name = "window"
	},
/obj/structure/window/reinforced/survival_pod{
	name = "window";
	dir = 10
	},
/obj/structure/window/reinforced/survival_pod{
	name = "window";
	dir = 2
	},
/turf/simulated/floor/grass,
/area/ruin/astroak)
"QI" = (
/obj/structure/window/reinforced/survival_pod{
	name = "window";
	dir = 10
	},
/turf/simulated/floor/grass,
/area/ruin/astroak)
"Rm" = (
/turf/simulated/wall/cult,
/area/ruin/astroak)
"RO" = (
/obj/effect/decal/remains/human,
/obj/effect/decal/cleanable/blood,
/turf/simulated/floor/wood/fancy/birch,
/area/ruin/astroak)
"Sf" = (
/obj/structure/closet,
/obj/item/clothing/suit/hooded/carp_costume,
/obj/item/clothing/suit/hooded/carp_costume,
/turf/simulated/floor/wood/fancy/birch,
/area/ruin/astroak)
"Tw" = (
/obj/item/chair/wood,
/turf/simulated/floor/wood/fancy/birch,
/area/ruin/astroak)
"TW" = (
/mob/living/simple_animal/hostile/carp,
/turf/simulated/floor/plating/asteroid/airless,
/area/ruin/astroak)
"Uy" = (
/obj/item/fluff/rsik_katana,
/obj/effect/decal/remains/human,
/turf/simulated/floor/wood/fancy/birch,
/area/ruin/astroak)
"Vp" = (
/obj/item/flashlight/lantern,
/obj/structure/window/reinforced,
/turf/simulated/floor/wood/fancy/birch,
/area/ruin/astroak)
"Wd" = (
/obj/item/fish_eggs/clownfish,
/turf/simulated/floor/indestructible/beach/water/deep/dense,
/area/ruin/astroak)
"Yx" = (
/obj/structure/window/reinforced/survival_pod{
	name = "window";
	dir = 2
	},
/obj/structure/window/reinforced/survival_pod{
	dir = 8;
	name = "window"
	},
/turf/simulated/floor/grass,
/area/ruin/astroak)
"ZC" = (
/obj/structure/table_frame/wood,
/obj/item/flashlight/lantern,
/turf/simulated/floor/wood/fancy/birch,
/area/ruin/astroak)
"ZY" = (
/obj/structure/window/reinforced/survival_pod{
	name = "window";
	dir = 1
	},
/obj/machinery/door/window/survival_pod{
	dir = 8
	},
/turf/simulated/floor/grass,
/area/ruin/astroak)

(1,1,1) = {"
PM
PM
PM
PM
PM
PM
PM
PM
PM
PM
PM
PM
PM
PM
PM
PM
PM
PM
PM
PM
PM
PM
PM
PM
PM
PM
PM
PM
PM
PM
"}
(2,1,1) = {"
PM
PM
PM
PM
PM
PM
PM
PM
PM
KJ
PM
zb
PM
PM
PM
PM
PM
PM
PM
PM
PM
PM
Md
Md
Md
PM
PM
PM
PM
PM
"}
(3,1,1) = {"
PM
PM
PM
PM
PM
PM
PM
PM
KJ
KJ
KJ
PM
PM
PM
PM
PM
PM
PM
PM
PM
Md
Md
Md
Md
TW
Md
PM
PM
PM
PM
"}
(4,1,1) = {"
PM
PM
PM
PM
PM
PM
PM
KJ
KJ
KJ
KJ
sX
sX
PM
PM
PM
PM
PM
PM
Md
Md
Md
Md
Md
Md
Md
PM
PM
PM
PM
"}
(5,1,1) = {"
PM
PM
PM
PM
PM
PM
KJ
KJ
KJ
EW
KJ
sX
Eg
Eg
PM
PM
PM
PM
TW
Md
Md
ZY
LX
BG
Yx
Md
Md
PM
PM
PM
"}
(6,1,1) = {"
PM
PM
PM
PM
PM
KJ
KJ
KJ
KJ
EW
KJ
sX
Eg
Eg
Eg
Eg
sX
sX
sX
uI
uI
Nw
zR
zR
QI
Yx
Md
PM
PM
PM
"}
(7,1,1) = {"
PM
PM
PM
PM
zb
sX
sX
sX
KJ
GI
KJ
sX
Eg
Eg
Eg
sX
sX
GT
sX
sX
Ky
zR
zR
Ky
cH
Bj
Md
Md
PM
PM
"}
(8,1,1) = {"
PM
PM
PM
PM
PM
sX
Eg
sX
eM
eM
sX
sX
sX
sX
ne
sX
Wd
GT
GT
DS
zR
zR
Ga
zR
gJ
Md
Md
Md
Md
PM
"}
(9,1,1) = {"
PM
PM
PM
PM
PM
Eg
Eg
sX
KJ
KJ
oY
KJ
lt
KJ
KJ
Vp
GT
GT
Wd
sX
zR
zR
zR
zR
Af
Md
Md
Md
PM
PM
"}
(10,1,1) = {"
PM
PM
PM
PM
Eg
Eg
sX
sX
KJ
gl
wk
Py
KJ
KJ
KJ
Av
ED
rb
Hb
sX
gy
zR
zR
zR
QI
Yx
Md
Md
Md
PM
"}
(11,1,1) = {"
PM
PM
PM
Eg
Eg
Eg
Eg
sX
sX
NL
KJ
gK
MC
qF
qF
qF
KJ
KJ
DP
GG
zR
zR
zR
zR
zR
QD
Md
Md
Md
PM
"}
(12,1,1) = {"
PM
PM
PM
PM
Eg
Eg
Eg
Eg
sX
nL
KJ
lt
KJ
sF
zg
KJ
KJ
KJ
KJ
cD
rD
zR
Ky
zR
cH
Ih
Md
Md
TW
Md
"}
(13,1,1) = {"
PM
PM
PM
PM
Eg
Eg
Eg
Eg
sX
FE
KJ
KJ
KJ
KJ
KJ
KJ
RO
KJ
Tw
kz
zR
zR
zR
gy
gJ
Md
Md
Md
Md
PM
"}
(14,1,1) = {"
PM
PM
PM
zb
PM
Eg
Eg
Eg
sX
OV
KJ
KJ
zC
KJ
KJ
KJ
KJ
KJ
KJ
tE
zR
zR
zR
zR
gJ
Md
Md
Md
Md
PM
"}
(15,1,1) = {"
PM
PM
PM
PM
PM
Eg
Eg
Eg
sX
uJ
KJ
sT
wk
EW
aP
KJ
KJ
oY
wk
fM
zR
zR
zR
zR
It
Md
Md
Md
Md
PM
"}
(16,1,1) = {"
PM
PM
PM
PM
PM
Eg
Eg
Eg
sX
sX
KJ
KJ
DX
DC
sX
gl
Np
oi
yF
sX
gy
zR
zR
zR
gJ
Md
Md
Md
PM
PM
"}
(17,1,1) = {"
PM
PM
PM
PM
PM
tR
Eg
Eg
Eg
sX
eH
eH
KJ
RO
sX
KJ
KJ
GL
Jf
sX
sX
zR
Ky
zR
Hc
Yx
Md
Md
Md
PM
"}
(18,1,1) = {"
PM
PM
PM
PM
PM
tR
Eg
Eg
sX
sX
sX
sX
eH
OQ
sX
GL
KJ
Uy
GL
ZC
wU
zR
zR
zR
zR
gJ
Md
Md
Md
PM
"}
(19,1,1) = {"
PM
PM
PM
PM
PM
tR
Eg
Eg
Rm
zK
Lr
sX
yF
yF
sX
KJ
KJ
GL
Sf
sX
sX
zR
zR
zR
cH
Bj
Md
Md
PM
PM
"}
(20,1,1) = {"
PM
PM
PM
PM
PM
tR
Eg
Eg
Rm
KJ
gE
Lr
Lr
Lr
sX
KJ
wk
KJ
HE
sX
DN
zR
cH
eJ
fW
Md
Md
Md
PM
PM
"}
(21,1,1) = {"
PM
PM
PM
PM
PM
tR
Eg
Rm
Rm
Ii
Ii
KJ
mM
pq
sX
Ni
bV
Be
sX
sX
eJ
eJ
fW
Md
Md
Md
Md
Md
PM
PM
"}
(22,1,1) = {"
PM
PM
PM
PM
PM
Eg
Eg
Rm
nG
Ii
qO
KJ
Hd
Ii
sX
sX
sX
sX
sX
Eg
Md
Md
Md
Md
Md
Md
Md
PM
PM
PM
"}
(23,1,1) = {"
PM
PM
PM
PM
Eg
Eg
Eg
BY
hC
dw
wh
wh
Qw
Ii
lA
Rm
Eg
Eg
Eg
Eg
Md
Md
Md
Md
Md
Md
Md
PM
PM
PM
"}
(24,1,1) = {"
PM
PM
PM
PM
PM
Eg
Eg
Rm
HL
Ii
nO
KJ
Ii
Bi
zN
Rm
Eg
Eg
Eg
Eg
Md
Md
Md
PM
PM
Md
PM
PM
PM
PM
"}
(25,1,1) = {"
PM
PM
PM
PM
Eg
Eg
Eg
sX
Ii
KJ
KJ
Ii
qO
Ii
Ge
Rm
Eg
Eg
Eg
Eg
PM
PM
PM
PM
PM
PM
PM
zb
PM
PM
"}
(26,1,1) = {"
PM
PM
PM
PM
PM
Eg
Eg
sX
Ge
ly
Ii
Ii
Ii
Rm
Rm
Rm
Eg
Eg
Eg
Eg
PM
PM
PM
PM
PM
PM
PM
PM
PM
PM
"}
(27,1,1) = {"
PM
PM
PM
PM
PM
tR
Eg
sX
Rm
Rm
pB
EX
mw
Rm
Eg
Eg
Eg
Eg
Eg
PM
PM
PM
PM
PM
PM
PM
PM
PM
PM
PM
"}
(28,1,1) = {"
PM
PM
zb
PM
PM
tR
Eg
Eg
Eg
Rm
Rm
sX
sX
Rm
Eg
Eg
Eg
Eg
PM
PM
PM
zb
PM
PM
PM
PM
PM
PM
PM
PM
"}
(29,1,1) = {"
PM
PM
PM
PM
PM
PM
PM
Eg
Eg
Eg
Eg
Eg
Rm
Eg
Eg
Eg
Eg
PM
yT
PM
PM
PM
PM
PM
PM
PM
PM
PM
PM
PM
"}
(30,1,1) = {"
PM
PM
PM
PM
PM
PM
PM
PM
PM
Eg
Eg
Eg
Eg
Eg
Eg
PM
PM
PM
PM
PM
PM
PM
PM
PM
PM
PM
PM
PM
PM
PM
"}
(31,1,1) = {"
PM
PM
PM
PM
PM
PM
PM
PM
PM
PM
zb
PM
PM
Eg
Eg
PM
PM
PM
PM
PM
PM
PM
PM
PM
PM
PM
PM
PM
PM
PM
"}
(32,1,1) = {"
PM
PM
PM
PM
PM
PM
PM
PM
PM
PM
PM
PM
PM
PM
PM
PM
PM
PM
PM
PM
PM
PM
PM
PM
PM
PM
PM
PM
PM
PM
"}
