//MAP CONVERTED BY dmm2tgm.py THIS HEADER COMMENT PREVENTS RECONVERSION, DO NOT REMOVE
"aP" = (
/obj/structure/cult/archives,
/obj/item/clothing/suit/space/cult,
/turf/simulated/floor/engine/cult,
/area/ruin/space/astroak)
"bV" = (
/obj/structure/flora/tree/dead,
/turf/simulated/floor/grass,
/area/ruin/space/astroak)
"cb" = (
/obj/structure/cult/pylon,
/turf/simulated/floor/engine/cult,
/area/ruin/space/astroak)
"cD" = (
/obj/effect/turf_decal{
	dir = 5;
	icon_state = "grass_edge_medium";
	name = "grass"
	},
/obj/effect/turf_decal{
	icon_state = "grass_edge_medium_corner";
	name = "grass"
	},
/turf/simulated/floor/plating/asteroid,
/area/ruin/space/astroak)
"cH" = (
/obj/item/toy/sword,
/turf/simulated/floor/wood/fancy/birch,
/area/ruin/space/astroak)
"cT" = (
/obj/item/trash/candle,
/turf/simulated/floor/wood/fancy/birch,
/area/ruin/space/astroak)
"dw" = (
/obj/effect/landmark/tiles/damageturf,
/turf/simulated/floor/wood/fancy/birch,
/area/ruin/space/astroak)
"eH" = (
/obj/effect/landmark/tiles/damageturf,
/obj/item/stack/sheet/cloth,
/obj/item/stack/rods,
/turf/simulated/floor/wood/fancy/birch,
/area/ruin/space/astroak)
"eJ" = (
/turf/simulated/floor/plating/asteroid/airless,
/area/ruin/unpowered/no_grav)
"eM" = (
/obj/structure/table/wood/fancy,
/obj/item/storage/fancy/cigarettes/cigpack_carp,
/turf/simulated/floor/wood/fancy/birch,
/area/ruin/space/astroak)
"fM" = (
/obj/structure/window/reinforced/survival_pod{
	dir = 6;
	name = "window"
	},
/obj/structure/window/reinforced/survival_pod{
	name = "window";
	dir = 10
	},
/obj/structure/window/reinforced/survival_pod{
	name = "window";
	dir = 2
	},
/turf/simulated/floor/grass,
/area/ruin/space/astroak)
"fW" = (
/obj/item/fish_eggs/clownfish,
/turf/simulated/floor/indestructible/beach/water/deep/dense,
/area/ruin/space/astroak)
"gl" = (
/obj/effect/turf_decal{
	icon_state = "grass_edge_medium";
	name = "grass"
	},
/obj/effect/turf_decal{
	dir = 1;
	icon_state = "grass_edge_medium";
	name = "grass"
	},
/turf/simulated/floor/plating/asteroid,
/area/ruin/space/astroak)
"gw" = (
/obj/effect/decal/cleanable/blood/tracks{
	dir = 8
	},
/turf/simulated/floor/wood/fancy/birch,
/area/ruin/space/astroak)
"gy" = (
/obj/item/trash/candle,
/obj/effect/decal/cleanable/blood/tracks{
	dir = 8
	},
/turf/simulated/floor/wood/fancy/birch,
/area/ruin/space/astroak)
"gE" = (
/obj/machinery/shield/cult/barrier,
/turf/simulated/floor/engine/cult,
/area/ruin/space/astroak)
"gJ" = (
/obj/effect/turf_decal{
	dir = 6;
	icon_state = "grass_edge_medium";
	name = "grass"
	},
/obj/effect/turf_decal{
	icon_state = "grass_edge_medium_corner";
	name = "grass";
	dir = 8
	},
/turf/simulated/floor/plating/asteroid,
/area/ruin/space/astroak)
"gK" = (
/obj/structure/window/full/paperframe,
/obj/structure/curtain/open/shower/security,
/turf/simulated/floor/wood/birch,
/area/ruin/space/astroak)
"hC" = (
/obj/item/trash/tastybread,
/turf/simulated/floor/wood/fancy/birch,
/area/ruin/space/astroak)
"kz" = (
/obj/structure/closet,
/obj/item/clothing/suit/hooded/salmon_costume,
/turf/simulated/floor/wood/fancy/birch,
/area/ruin/space/astroak)
"lt" = (
/obj/item/flag/cult,
/obj/effect/landmark/tiles/damageturf,
/turf/simulated/floor/wood/fancy/birch,
/area/ruin/space/astroak)
"ly" = (
/obj/effect/landmark/tiles/damageturf,
/turf/simulated/floor/wood/fancy/birch{
	oxygen = 0;
	nitrogen = 0;
	temperature = 2.7
	},
/area/ruin/unpowered/no_grav)
"lA" = (
/turf/simulated/wall/mineral/wood/nonmetal,
/area/ruin/unpowered/no_grav)
"lX" = (
/obj/effect/decal/cleanable/blood/old,
/turf/simulated/floor/engine/cult,
/area/ruin/space/astroak)
"mw" = (
/turf/simulated/mineral/random/high_chance,
/area/ruin/unpowered/no_grav)
"mM" = (
/obj/item/reagent_containers/glass/bucket/wooden,
/turf/simulated/floor/wood/fancy/birch,
/area/ruin/space/astroak)
"ne" = (
/obj/structure/table_frame/wood,
/obj/effect/landmark/tiles/damageturf,
/obj/item/flashlight/lantern{
	icon_state = "lantern-on"
	},
/turf/simulated/floor/wood/fancy/birch,
/area/ruin/space/astroak)
"nr" = (
/obj/structure/wooden_sign{
	desc = "Астроак открыт для посещения";
	name = "Астроак"
	},
/obj/structure/sign/holy{
	pixel_x = 0;
	pixel_y = 32
	},
/turf/simulated/floor/grass,
/area/ruin/space/astroak)
"nA" = (
/obj/item/stack/sheet/wood,
/obj/effect/landmark/tiles/damageturf,
/turf/simulated/floor/wood/fancy/birch,
/area/ruin/space/astroak)
"nG" = (
/obj/structure/table/wood/fancy/red,
/obj/item/flashlight/lantern{
	icon_state = "lantern-on"
	},
/turf/simulated/floor/wood/fancy/birch,
/area/ruin/space/astroak)
"nL" = (
/turf/simulated/wall/cult_fake,
/area/ruin/space/astroak)
"nO" = (
/mob/living/simple_animal/hostile/carp/mcarp,
/obj/effect/landmark/tiles/damageturf,
/turf/simulated/floor/wood/fancy/birch,
/area/ruin/space/astroak)
"oi" = (
/obj/structure/table_frame/wood,
/obj/effect/landmark/tiles/damageturf,
/obj/item/stack/tile/carpet/red,
/turf/simulated/floor/wood/fancy/birch,
/area/ruin/space/astroak)
"oY" = (
/obj/item/chair/wood,
/obj/effect/landmark/tiles/damageturf,
/turf/simulated/floor/wood/fancy/birch,
/area/ruin/space/astroak)
"pq" = (
/turf/simulated/wall/mineral/wood/nonmetal,
/area/ruin/space/astroak)
"pB" = (
/obj/structure/noticeboard{
	pixel_y = 30
	},
/turf/simulated/floor/grass,
/area/ruin/space/astroak)
"qF" = (
/obj/structure/cult/archives,
/obj/item/clothing/head/helmet/space/cult,
/obj/structure/sign/poster/contraband/very_robust{
	pixel_x = 0;
	pixel_y = 32
	},
/turf/simulated/floor/engine/cult,
/area/ruin/space/astroak)
"qO" = (
/obj/structure/statue/carp_mini{
	pixel_y = 16
	},
/obj/structure/table/wood/fancy/red,
/obj/effect/landmark/tiles/damageturf,
/turf/simulated/floor/wood/fancy/birch,
/area/ruin/space/astroak)
"rb" = (
/obj/effect/landmark/tiles/damageturf,
/obj/structure/cable{
	icon_state = "0-4"
	},
/turf/simulated/floor/wood/fancy/birch{
	oxygen = 0;
	nitrogen = 0;
	temperature = 2.7
	},
/area/ruin/unpowered/no_grav)
"rA" = (
/obj/item/reagent_containers/food/drinks/bottle/unholywater,
/turf/simulated/floor/wood/fancy/birch,
/area/ruin/space/astroak)
"rD" = (
/obj/effect/turf_decal{
	dir = 1;
	icon_state = "grass_edge_medium";
	name = "grass"
	},
/obj/effect/turf_decal{
	icon_state = "grass_edge_medium";
	name = "grass"
	},
/turf/simulated/floor/plating/asteroid,
/area/ruin/space/astroak)
"sF" = (
/obj/machinery/power/apc/worn_out{
	pixel_y = 26;
	dir = 1
	},
/obj/structure/cable{
	icon_state = "0-2"
	},
/turf/simulated/floor/wood/fancy/birch,
/area/ruin/space/astroak)
"sT" = (
/obj/structure/sacrificealtar,
/obj/item/nullrod/carp,
/turf/simulated/floor/wood/fancy/birch,
/area/ruin/space/astroak)
"sX" = (
/obj/structure/flora/ausbushes/sparsegrass,
/obj/structure/window/reinforced/survival_pod{
	name = "window";
	dir = 10
	},
/turf/simulated/floor/grass,
/area/ruin/space/astroak)
"tE" = (
/obj/structure/bookcase/random/religion,
/turf/simulated/floor/wood/fancy/birch,
/area/ruin/space/astroak)
"tR" = (
/obj/effect/decal/cleanable/blood/writing,
/turf/simulated/floor/engine/cult,
/area/ruin/space/astroak)
"uI" = (
/obj/structure/sign/poster/official/religious{
	pixel_x = 32;
	pixel_y = 0
	},
/turf/simulated/floor/wood/fancy/birch,
/area/ruin/space/astroak)
"uJ" = (
/obj/effect/decal/cleanable/blood/tracks,
/turf/simulated/floor/wood/fancy/birch,
/area/ruin/space/astroak)
"wh" = (
/obj/effect/spawner/random_spawners/blood_20,
/turf/simulated/floor/wood/fancy/birch,
/area/ruin/space/astroak)
"wk" = (
/obj/item/trash/candy,
/turf/simulated/floor/wood/fancy/birch,
/area/ruin/space/astroak)
"wU" = (
/obj/item/trash/chips,
/turf/simulated/floor/wood/fancy/birch,
/area/ruin/space/astroak)
"yF" = (
/mob/living/simple_animal/hostile/carp/mcarp,
/turf/simulated/floor/wood/fancy/birch,
/area/ruin/space/astroak)
"yT" = (
/turf/template_noop,
/area/template_noop)
"zb" = (
/obj/structure/cult/forge,
/turf/simulated/floor/engine/cult,
/area/ruin/space/astroak)
"zg" = (
/obj/structure/sign/poster/contraband/wanted{
	pixel_x = 0;
	pixel_y = 32
	},
/turf/simulated/floor/grass,
/area/ruin/space/astroak)
"zC" = (
/obj/effect/decal/cleanable/glass/plasma,
/obj/structure/railing{
	dir = 8
	},
/turf/simulated/floor/wood/fancy/birch,
/area/ruin/space/astroak)
"zF" = (
/obj/item/stack/sheet/wood,
/obj/structure/cable{
	icon_state = "1-8"
	},
/turf/simulated/floor/wood/fancy/birch,
/area/ruin/space/astroak)
"zK" = (
/obj/effect/turf_decal{
	dir = 10;
	icon_state = "grass_edge_medium";
	name = "grass"
	},
/obj/effect/turf_decal{
	dir = 1;
	icon_state = "grass_edge_medium_corner";
	name = "grass"
	},
/turf/simulated/floor/plating/asteroid,
/area/ruin/space/astroak)
"zN" = (
/obj/structure/closet/crate,
/obj/item/pickaxe/diamond,
/obj/item/flashlight/lantern,
/turf/simulated/floor/grass,
/area/ruin/space/astroak)
"zR" = (
/obj/item/melee/cultblade/dagger,
/turf/simulated/floor/engine/cult,
/area/ruin/space/astroak)
"Aa" = (
/obj/structure/bed,
/obj/item/bedsheet/wiz,
/obj/effect/decal/cleanable/blood,
/obj/effect/decal/remains/human,
/turf/simulated/floor/wood/fancy/birch,
/area/ruin/space/astroak)
"Af" = (
/mob/living/simple_animal/hostile/illusion/cult{
	deathmessage = "disappears into the air with a cry of agony";
	desc = "The deceived soul";
	health = 200;
	maxHealth = 200;
	name = "The soul of the cultist";
	icon = 'icons/mob/mob.dmi';
	icon_living = "shade";
	icon_state = "shade";
	icon_dead = "shade_dead";
	melee_damage_lower = 10;
	melee_damage_upper = 25
	},
/turf/simulated/floor/engine/cult,
/area/ruin/space/astroak)
"Av" = (
/obj/structure/window/reinforced/survival_pod{
	name = "window";
	dir = 9
	},
/turf/simulated/floor/grass,
/area/ruin/space/astroak)
"Ay" = (
/obj/structure/cult/altar,
/obj/item/tome,
/turf/simulated/floor/engine/cult,
/area/ruin/space/astroak)
"Be" = (
/obj/structure/window/reinforced/survival_pod{
	dir = 8;
	name = "window"
	},
/turf/simulated/floor/grass,
/area/ruin/space/astroak)
"Bj" = (
/mob/living/simple_animal/hostile/carp,
/turf/template_noop,
/area/template_noop)
"BG" = (
/obj/item/trash/candle{
	pixel_y = 11
	},
/turf/simulated/floor/wood/fancy/birch,
/area/ruin/space/astroak)
"BY" = (
/obj/structure/sign/poster/official/tsf_emblem{
	pixel_x = 0;
	pixel_y = 32
	},
/turf/simulated/floor/grass,
/area/ruin/space/astroak)
"CG" = (
/obj/item/shield/riot/buckler,
/turf/simulated/floor/wood/fancy/birch,
/area/ruin/space/astroak)
"DC" = (
/obj/item/restraints/legcuffs/bola/cult,
/turf/simulated/floor/engine/cult,
/area/ruin/space/astroak)
"DN" = (
/obj/item/fluff/rsik_katana,
/obj/effect/landmark/tiles/damageturf,
/obj/effect/decal/cleanable/blood/gibs/old,
/obj/effect/decal/remains/human,
/turf/simulated/floor/wood/fancy/birch,
/area/ruin/space/astroak)
"DP" = (
/obj/structure/window/reinforced/survival_pod{
	dir = 6;
	name = "window"
	},
/turf/simulated/floor/grass,
/area/ruin/space/astroak)
"DS" = (
/obj/effect/decal/cleanable/glass/plasma,
/obj/item/reagent_containers/glass/bucket/wooden,
/obj/structure/railing{
	dir = 8
	},
/turf/simulated/floor/wood/fancy/birch,
/area/ruin/space/astroak)
"DX" = (
/turf/simulated/floor/wood/fancy/birch,
/area/ruin/space/astroak)
"Eg" = (
/turf/simulated/floor/wood/fancy/birch{
	oxygen = 0;
	nitrogen = 0;
	temperature = 2.7
	},
/area/ruin/unpowered/no_grav)
"ED" = (
/obj/effect/decal/cleanable/blood/old,
/obj/item/flag/cult,
/turf/simulated/floor/wood/fancy/birch,
/area/ruin/space/astroak)
"EW" = (
/obj/structure/curtain/open/shower/security,
/obj/structure/mineral_door/wood,
/turf/simulated/floor/wood/fancy/birch,
/area/ruin/space/astroak)
"EX" = (
/obj/effect/landmark/tiles/damageturf,
/obj/effect/decal/cleanable/blood/gibs/old,
/obj/effect/decal/remains/human,
/obj/structure/cable{
	icon_state = "4-8"
	},
/turf/simulated/floor/wood/fancy/birch{
	oxygen = 0;
	nitrogen = 0;
	temperature = 2.7
	},
/area/ruin/unpowered/no_grav)
"FE" = (
/obj/structure/railing,
/turf/simulated/floor/wood/fancy/birch,
/area/ruin/space/astroak)
"Ga" = (
/obj/effect/decal/cleanable/blood/gibs/old,
/obj/effect/landmark/tiles/damageturf,
/turf/simulated/floor/wood/fancy/birch,
/area/ruin/space/astroak)
"Ge" = (
/obj/structure/window/reinforced/survival_pod{
	name = "window";
	dir = 4
	},
/turf/simulated/floor/grass,
/area/ruin/space/astroak)
"GG" = (
/obj/structure/window/reinforced/survival_pod{
	name = "window";
	dir = 2
	},
/obj/structure/window/reinforced/survival_pod{
	name = "window";
	dir = 4
	},
/turf/simulated/floor/grass,
/area/ruin/space/astroak)
"GI" = (
/obj/effect/landmark/tiles/damageturf,
/obj/structure/sign/poster/ripped{
	pixel_x = -32
	},
/turf/simulated/floor/wood/fancy/birch,
/area/ruin/space/astroak)
"GL" = (
/obj/structure/flora/grass/jungle,
/turf/simulated/floor/grass,
/area/ruin/space/astroak)
"GT" = (
/obj/machinery/door/window/survival_pod{
	dir = 8
	},
/obj/effect/turf_decal{
	icon_state = "grass_edge_medium";
	name = "grass"
	},
/obj/effect/turf_decal{
	dir = 1;
	icon_state = "grass_edge_medium";
	name = "grass"
	},
/turf/simulated/floor/plating/asteroid,
/area/ruin/space/astroak)
"Hb" = (
/obj/structure/window/reinforced/survival_pod{
	name = "window";
	dir = 10
	},
/turf/simulated/floor/grass,
/area/ruin/space/astroak)
"Hc" = (
/obj/effect/decal/cleanable/blood/gibs/old,
/turf/simulated/floor/wood/fancy/birch,
/area/ruin/space/astroak)
"Hd" = (
/obj/effect/decal/remains/human,
/obj/effect/decal/cleanable/blood,
/turf/simulated/floor/wood/fancy/birch,
/area/ruin/space/astroak)
"HE" = (
/obj/structure/window/reinforced/survival_pod{
	name = "window";
	dir = 2
	},
/turf/simulated/floor/grass,
/area/ruin/space/astroak)
"HL" = (
/turf/simulated/floor/engine/cult,
/area/ruin/space/astroak)
"HP" = (
/obj/structure/sacrificealtar,
/turf/simulated/floor/wood/fancy/birch,
/area/ruin/space/astroak)
"Ih" = (
/obj/effect/turf_decal{
	dir = 9;
	icon_state = "grass_edge_medium";
	name = "grass"
	},
/obj/effect/turf_decal{
	icon_state = "grass_edge_medium_corner";
	name = "grass";
	dir = 4
	},
/turf/simulated/floor/plating/asteroid,
/area/ruin/space/astroak)
"Ii" = (
/obj/structure/bed,
/obj/item/bedsheet/fluff/hugosheet,
/turf/simulated/floor/wood/fancy/birch,
/area/ruin/space/astroak)
"It" = (
/obj/effect/decal/cleanable/blood/gibs/old,
/obj/effect/landmark/tiles/damageturf,
/mob/living/simple_animal/pet/dog/corgi/narsie{
	name = "Nars-Corgi";
	melee_damage_lower = 9;
	melee_damage_upper = 15;
	maxHealth = 75;
	health = 75;
	faction = list("neutral","cult", "illusion")
	},
/turf/simulated/floor/wood/fancy/birch,
/area/ruin/space/astroak)
"Jf" = (
/obj/item/fish_eggs/babycarp,
/obj/item/shard,
/obj/effect/landmark/tiles/damageturf,
/obj/structure/railing/corner{
	dir = 8
	},
/obj/structure/railing/corner{
	dir = 1
	},
/turf/simulated/floor/wood/fancy/birch,
/area/ruin/space/astroak)
"Ky" = (
/obj/structure/window/reinforced/survival_pod{
	name = "window";
	dir = 10
	},
/obj/structure/window/reinforced/survival_pod{
	name = "window";
	dir = 9
	},
/obj/structure/window/reinforced/survival_pod{
	dir = 8;
	name = "window"
	},
/turf/simulated/floor/grass,
/area/ruin/space/astroak)
"KJ" = (
/turf/simulated/floor/indestructible/beach/water/deep/dense,
/area/ruin/space/astroak)
"Lr" = (
/obj/structure/mineral_door/wood,
/turf/simulated/floor/wood/fancy/birch,
/area/ruin/space/astroak)
"LX" = (
/obj/item/trash/candle{
	pixel_y = 13
	},
/turf/simulated/floor/wood/fancy/birch,
/area/ruin/space/astroak)
"Md" = (
/obj/effect/landmark/tiles/damageturf,
/obj/item/flashlight/lantern{
	icon_state = "lantern-on"
	},
/turf/simulated/floor/wood/fancy/birch,
/area/ruin/space/astroak)
"MC" = (
/obj/effect/decal/cleanable/blood/writing{
	dir = 4
	},
/obj/effect/rune,
/turf/simulated/floor/engine/cult,
/area/ruin/space/astroak)
"Ni" = (
/obj/effect/turf_decal{
	dir = 1;
	icon_state = "grass_edge_medium";
	name = "grass"
	},
/obj/effect/turf_decal{
	dir = 8;
	icon_state = "grass_edge_medium";
	name = "grass"
	},
/obj/effect/turf_decal{
	icon_state = "grass_edge_medium_corner";
	name = "grass";
	dir = 4
	},
/turf/simulated/floor/plating/asteroid,
/area/ruin/space/astroak)
"Np" = (
/obj/structure/flora/ausbushes/sparsegrass,
/turf/simulated/floor/grass,
/area/ruin/space/astroak)
"Nw" = (
/obj/structure/window/reinforced/survival_pod{
	name = "window";
	dir = 4
	},
/obj/structure/window/reinforced/survival_pod{
	name = "window";
	dir = 2
	},
/turf/simulated/floor/grass,
/area/ruin/space/astroak)
"NL" = (
/obj/effect/turf_decal{
	dir = 8;
	icon_state = "grass_edge_medium";
	name = "grass"
	},
/obj/effect/turf_decal{
	dir = 4;
	icon_state = "grass_edge_medium";
	name = "grass"
	},
/turf/simulated/floor/plating/asteroid,
/area/ruin/space/astroak)
"OQ" = (
/obj/effect/turf_decal{
	dir = 10;
	icon_state = "grass_edge_medium";
	name = "grass"
	},
/obj/effect/turf_decal{
	icon_state = "grass_edge_medium_corner";
	name = "grass";
	dir = 8
	},
/obj/effect/turf_decal{
	dir = 1;
	icon_state = "grass_edge_medium_corner";
	name = "grass"
	},
/turf/simulated/floor/plating/asteroid,
/area/ruin/space/astroak)
"OV" = (
/obj/item/chair/wood,
/mob/living/simple_animal/hostile/carp/mcarp,
/obj/effect/landmark/tiles/damageturf,
/obj/structure/railing/corner{
	dir = 8
	},
/turf/simulated/floor/wood/fancy/birch,
/area/ruin/space/astroak)
"Py" = (
/obj/structure/table/wood/fancy/red,
/obj/item/toy/carpplushie/ice,
/obj/effect/landmark/tiles/damageturf,
/turf/simulated/floor/wood/fancy/birch,
/area/ruin/space/astroak)
"PM" = (
/obj/structure/table/wood/fancy/red,
/obj/item/toy/carpplushie/nebula,
/turf/simulated/floor/wood/fancy/birch,
/area/ruin/space/astroak)
"PS" = (
/obj/structure/closet/crate/trashcart/gibs,
/turf/simulated/floor/engine/cult,
/area/ruin/space/astroak)
"Qw" = (
/obj/structure/closet,
/obj/item/clothing/suit/hooded/carp_costume,
/turf/simulated/floor/wood/fancy/birch,
/area/ruin/space/astroak)
"Qy" = (
/obj/structure/decorative_structures/corpse,
/obj/effect/landmark/tiles/damageturf,
/obj/effect/decal/cleanable/blood/gibs/old,
/turf/simulated/floor/wood/fancy/birch,
/area/ruin/space/astroak)
"QD" = (
/obj/structure/mineral_door/wood,
/obj/structure/barricade/wooden/crude,
/obj/structure/cable{
	icon_state = "4-8"
	},
/turf/simulated/floor/wood/fancy/birch,
/area/ruin/space/astroak)
"QI" = (
/obj/effect/decal/cleanable/blood,
/obj/effect/decal/remains/human,
/obj/effect/landmark/tiles/damageturf,
/turf/simulated/floor/wood/fancy/birch,
/area/ruin/space/astroak)
"QO" = (
/obj/effect/turf_decal{
	dir = 1;
	icon_state = "grass_edge_medium";
	name = "grass"
	},
/obj/effect/turf_decal{
	icon_state = "grass_edge_medium_corner";
	name = "grass"
	},
/obj/effect/turf_decal{
	icon_state = "grass_edge_medium_corner";
	name = "grass";
	dir = 4
	},
/turf/simulated/floor/plating/asteroid,
/area/ruin/space/astroak)
"Rm" = (
/obj/structure/cult/altar,
/obj/item/book_of_babel,
/turf/simulated/floor/engine/cult,
/area/ruin/space/astroak)
"RO" = (
/obj/structure/mineral_door/wood,
/turf/simulated/floor/wood/birch,
/area/ruin/space/astroak)
"Sf" = (
/obj/machinery/door/window/survival_pod{
	dir = 2
	},
/obj/effect/turf_decal{
	dir = 8;
	icon_state = "grass_edge_medium";
	name = "grass"
	},
/obj/effect/turf_decal{
	dir = 4;
	icon_state = "grass_edge_medium";
	name = "grass"
	},
/turf/simulated/floor/plating/asteroid,
/area/ruin/space/astroak)
"Tw" = (
/obj/structure/window/reinforced/survival_pod{
	name = "window";
	dir = 2
	},
/obj/structure/flora/grass/jungle,
/turf/simulated/floor/grass,
/area/ruin/space/astroak)
"TW" = (
/obj/structure/mineral_door/wood,
/obj/structure/barricade/wooden/crude,
/turf/simulated/floor/wood/fancy/birch,
/area/ruin/space/astroak)
"Uk" = (
/obj/item/melee/cultblade,
/turf/simulated/floor/engine/cult,
/area/ruin/space/astroak)
"Uy" = (
/turf/simulated/floor/grass,
/area/ruin/space/astroak)
"UE" = (
/obj/structure/closet,
/obj/item/stack/sheet/runed_metal_fake,
/turf/simulated/floor/engine/cult,
/area/ruin/space/astroak)
"Vp" = (
/obj/structure/window/reinforced/survival_pod{
	name = "window";
	dir = 1
	},
/obj/structure/window/reinforced/survival_pod{
	dir = 8;
	name = "window"
	},
/turf/simulated/floor/grass,
/area/ruin/space/astroak)
"Wd" = (
/obj/structure/window/reinforced/survival_pod{
	name = "window";
	dir = 2
	},
/obj/structure/window/reinforced/survival_pod{
	dir = 8;
	name = "window"
	},
/turf/simulated/floor/grass,
/area/ruin/space/astroak)
"Wi" = (
/obj/structure/window/reinforced/survival_pod{
	name = "window";
	dir = 2
	},
/obj/structure/window/reinforced/survival_pod{
	name = "window";
	dir = 2
	},
/obj/structure/window/reinforced/survival_pod{
	name = "window";
	dir = 4
	},
/turf/simulated/floor/grass,
/area/ruin/space/astroak)
"Yx" = (
/obj/effect/decal/cleanable/blood/old,
/obj/effect/landmark/tiles/damageturf,
/turf/simulated/floor/wood/fancy/birch,
/area/ruin/space/astroak)
"ZC" = (
/obj/structure/bed,
/obj/item/bedsheet/cult,
/turf/simulated/floor/wood/fancy/birch,
/area/ruin/space/astroak)
"ZY" = (
/obj/effect/landmark/tiles/damageturf,
/obj/structure/cable{
	icon_state = "4-8"
	},
/turf/simulated/floor/wood/fancy/birch,
/area/ruin/space/astroak)

(1,1,1) = {"
yT
yT
yT
yT
yT
yT
yT
yT
yT
yT
yT
yT
yT
yT
yT
yT
yT
yT
yT
yT
yT
yT
yT
yT
yT
yT
yT
yT
yT
yT
yT
yT
yT
yT
yT
yT
yT
yT
yT
yT
"}
(2,1,1) = {"
yT
yT
yT
yT
yT
yT
yT
yT
yT
yT
yT
yT
yT
yT
yT
yT
yT
yT
yT
yT
yT
yT
yT
yT
yT
yT
yT
yT
yT
yT
yT
yT
yT
yT
yT
yT
yT
yT
yT
yT
"}
(3,1,1) = {"
yT
yT
yT
yT
yT
yT
yT
yT
yT
yT
yT
yT
yT
yT
yT
yT
yT
yT
yT
yT
yT
yT
yT
yT
yT
yT
yT
yT
yT
yT
yT
yT
yT
yT
yT
yT
yT
yT
yT
yT
"}
(4,1,1) = {"
yT
yT
yT
yT
yT
yT
yT
yT
yT
yT
yT
yT
yT
Bj
yT
yT
yT
yT
yT
yT
yT
yT
yT
yT
yT
yT
yT
yT
yT
yT
yT
yT
yT
yT
yT
yT
yT
yT
yT
yT
"}
(5,1,1) = {"
yT
yT
yT
yT
yT
yT
yT
yT
yT
yT
yT
yT
yT
yT
yT
yT
yT
yT
yT
yT
yT
yT
yT
yT
yT
yT
yT
yT
yT
yT
yT
yT
yT
yT
yT
yT
yT
yT
yT
yT
"}
(6,1,1) = {"
yT
yT
yT
yT
yT
yT
yT
yT
yT
yT
yT
yT
yT
ly
yT
yT
yT
yT
yT
yT
yT
yT
yT
Bj
yT
yT
eJ
eJ
eJ
yT
yT
yT
yT
yT
yT
yT
yT
yT
yT
yT
"}
(7,1,1) = {"
yT
yT
yT
yT
yT
yT
yT
yT
yT
yT
yT
yT
ly
ly
ly
yT
yT
yT
yT
yT
yT
yT
yT
eJ
eJ
eJ
eJ
eJ
eJ
eJ
yT
yT
yT
yT
yT
Bj
yT
yT
yT
yT
"}
(8,1,1) = {"
yT
yT
yT
yT
yT
yT
yT
yT
yT
yT
yT
ly
ly
ly
ly
lA
lA
yT
yT
yT
yT
yT
eJ
eJ
eJ
eJ
eJ
eJ
eJ
eJ
yT
yT
yT
yT
yT
yT
yT
yT
yT
yT
"}
(9,1,1) = {"
yT
yT
yT
Bj
yT
yT
yT
yT
yT
yT
ly
ly
ly
ly
ly
lA
mw
mw
yT
yT
yT
eJ
eJ
eJ
eJ
Vp
GT
Ky
Wd
eJ
eJ
yT
yT
yT
yT
yT
yT
yT
yT
yT
"}
(10,1,1) = {"
yT
yT
yT
yT
yT
yT
yT
yT
yT
ly
ly
ly
ly
rb
Eg
lA
mw
mw
mw
mw
pq
pq
pq
Be
Be
Av
gl
Np
Hb
Wd
eJ
yT
yT
yT
yT
yT
yT
yT
yT
yT
"}
(11,1,1) = {"
yT
yT
yT
yT
yT
yT
yT
yT
yT
lA
lA
lA
Eg
EX
ly
lA
mw
mw
mw
pq
pq
KJ
pq
pq
Np
Uy
OQ
cD
DP
GG
eJ
eJ
yT
yT
yT
yT
yT
yT
yT
yT
"}
(12,1,1) = {"
yT
yT
yT
yT
yT
yT
yT
yT
yT
lA
mw
pq
TW
QD
pq
pq
pq
pq
pq
pq
fW
KJ
KJ
pq
zg
Uy
bV
rD
HE
eJ
eJ
eJ
eJ
yT
yT
yT
yT
yT
yT
yT
"}
(13,1,1) = {"
yT
yT
yT
yT
yT
yT
yT
yT
yT
mw
mw
pq
dw
ZY
DX
DX
BG
dw
GI
FE
KJ
KJ
fW
pq
Uy
Uy
Uy
rD
Tw
eJ
eJ
eJ
yT
yT
yT
yT
yT
yT
yT
yT
"}
(14,1,1) = {"
yT
yT
yT
yT
yT
yT
yT
yT
mw
mw
mw
pq
sF
zF
nO
wU
DX
DX
DX
OV
DS
Jf
zC
pq
GL
Uy
gJ
Ih
Hb
Wd
eJ
eJ
eJ
yT
yT
yT
yT
yT
yT
yT
"}
(15,1,1) = {"
yT
yT
yT
yT
yT
yT
yT
mw
mw
mw
mw
pq
pq
PM
DX
HP
Qy
uJ
uJ
uJ
DX
DX
wk
EW
Uy
gJ
Ni
Uy
Uy
fM
eJ
eJ
eJ
yT
yT
yT
yT
yT
yT
yT
"}
(16,1,1) = {"
yT
yT
yT
yT
yT
yT
yT
yT
mw
mw
mw
mw
pq
oi
DX
BG
DX
cH
cT
DX
DX
DX
DX
pq
nr
gl
Np
Uy
DP
Wi
eJ
eJ
eJ
eJ
yT
yT
yT
yT
yT
yT
"}
(17,1,1) = {"
yT
yT
yT
yT
yT
yT
yT
yT
mw
mw
mw
mw
pq
qO
DX
DX
dw
DX
DX
DX
Hd
DX
oY
RO
NL
QO
Uy
GL
HE
eJ
eJ
eJ
eJ
yT
yT
yT
yT
yT
yT
yT
"}
(18,1,1) = {"
yT
yT
yT
yT
yT
yT
yT
yT
yT
mw
mw
mw
pq
nG
dw
DX
LX
dw
DX
DX
DX
dw
eH
pq
pB
zK
cD
Uy
HE
eJ
eJ
eJ
eJ
yT
yT
yT
yT
yT
yT
yT
"}
(19,1,1) = {"
yT
yT
yT
yT
yT
yT
yT
yT
yT
mw
mw
mw
pq
Py
DX
sT
yF
gw
hC
DX
uI
DX
yF
pq
BY
Uy
zK
NL
Sf
eJ
eJ
eJ
eJ
yT
yT
yT
yT
yT
yT
yT
"}
(20,1,1) = {"
yT
yT
yT
yT
yT
yT
yT
yT
yT
mw
mw
mw
pq
pq
DX
DX
CG
gy
pq
nA
pq
Lr
pq
pq
GL
Uy
Uy
Np
HE
eJ
eJ
eJ
yT
yT
yT
yT
yT
yT
yT
yT
"}
(21,1,1) = {"
yT
yT
yT
yT
yT
yT
yT
Bj
yT
yT
mw
mw
mw
pq
tE
tE
DX
QI
pq
DX
DX
wh
mM
pq
pq
Uy
Uy
Uy
sX
Wd
eJ
eJ
eJ
yT
Bj
yT
yT
yT
yT
yT
"}
(22,1,1) = {"
yT
yT
yT
yT
yT
yT
yT
yT
yT
yT
mw
mw
pq
pq
pq
pq
tE
eM
pq
wh
DX
DN
wh
ne
gK
Uy
Uy
Uy
Uy
HE
eJ
eJ
eJ
yT
yT
yT
yT
yT
yT
yT
"}
(23,1,1) = {"
yT
yT
yT
yT
yT
yT
yT
yT
yT
yT
mw
mw
nL
lt
gE
pq
pq
pq
pq
dw
DX
wh
Qw
pq
pq
Uy
Np
Uy
DP
GG
eJ
eJ
yT
yT
yT
yT
yT
yT
yT
yT
"}
(24,1,1) = {"
yT
yT
yT
yT
yT
yT
yT
yT
yT
yT
mw
mw
nL
Hc
Uk
gE
gE
gE
pq
dw
nO
DX
kz
pq
zN
Uy
DP
Ge
Nw
eJ
eJ
eJ
yT
yT
yT
yT
yT
yT
yT
yT
"}
(25,1,1) = {"
yT
yT
yT
yT
yT
yT
yT
yT
yT
yT
mw
nL
nL
HL
HL
DX
Ga
gE
pq
ZC
Aa
Ii
pq
pq
Ge
Ge
Nw
eJ
eJ
eJ
eJ
eJ
yT
yT
yT
yT
yT
yT
yT
yT
"}
(26,1,1) = {"
yT
yT
yT
yT
yT
yT
yT
yT
yT
mw
mw
nL
aP
HL
Af
dw
rA
ED
pq
pq
pq
pq
pq
mw
eJ
eJ
eJ
eJ
eJ
eJ
eJ
yT
yT
yT
yT
yT
yT
yT
yT
yT
"}
(27,1,1) = {"
yT
yT
yT
yT
yT
yT
yT
yT
mw
mw
mw
nL
qF
MC
tR
tR
lX
HL
Rm
nL
mw
mw
mw
mw
eJ
eJ
eJ
eJ
eJ
eJ
eJ
yT
yT
yT
yT
yT
yT
yT
yT
yT
"}
(28,1,1) = {"
yT
yT
yT
yT
yT
yT
yT
yT
yT
mw
mw
nL
zb
HL
Yx
Md
HL
zR
Ay
nL
mw
mw
mw
mw
mw
eJ
eJ
yT
yT
eJ
yT
yT
yT
yT
yT
yT
yT
yT
yT
yT
"}
(29,1,1) = {"
yT
yT
yT
Bj
yT
yT
yT
yT
mw
mw
mw
pq
HL
DX
DX
HL
Af
HL
cb
nL
mw
mw
mw
mw
mw
yT
yT
yT
yT
yT
yT
yT
yT
yT
yT
yT
yT
yT
yT
yT
"}
(30,1,1) = {"
yT
yT
yT
yT
yT
yT
yT
yT
yT
mw
mw
pq
cb
DC
HL
HL
HL
nL
nL
nL
mw
mw
mw
mw
yT
yT
yT
yT
yT
yT
yT
yT
yT
yT
yT
yT
yT
yT
yT
yT
"}
(31,1,1) = {"
yT
yT
yT
yT
yT
yT
yT
yT
yT
yT
mw
pq
nL
nL
PS
It
UE
nL
mw
mw
mw
mw
mw
yT
yT
yT
yT
yT
yT
yT
yT
yT
yT
yT
yT
yT
yT
yT
yT
yT
"}
(32,1,1) = {"
yT
yT
yT
yT
yT
yT
yT
yT
yT
yT
mw
mw
mw
nL
nL
pq
pq
nL
mw
mw
mw
mw
yT
yT
yT
yT
yT
yT
yT
yT
yT
yT
yT
yT
yT
yT
yT
yT
yT
yT
"}
(33,1,1) = {"
yT
yT
yT
yT
yT
yT
yT
yT
yT
yT
yT
mw
mw
mw
mw
mw
mw
mw
mw
mw
mw
yT
yT
yT
yT
yT
yT
yT
yT
yT
yT
yT
yT
yT
yT
yT
yT
yT
yT
yT
"}
(34,1,1) = {"
yT
yT
yT
yT
yT
yT
yT
yT
yT
yT
yT
yT
yT
mw
mw
mw
mw
mw
mw
yT
yT
yT
yT
yT
yT
yT
yT
yT
yT
yT
Bj
yT
yT
yT
yT
yT
yT
yT
yT
yT
"}
(35,1,1) = {"
yT
yT
yT
yT
yT
yT
yT
yT
yT
yT
yT
yT
yT
yT
yT
mw
mw
mw
yT
yT
yT
yT
yT
yT
yT
yT
yT
yT
yT
yT
yT
yT
yT
yT
yT
yT
yT
yT
yT
yT
"}
(36,1,1) = {"
yT
yT
yT
yT
yT
yT
yT
yT
yT
Bj
yT
yT
yT
yT
yT
yT
yT
yT
yT
yT
yT
yT
yT
yT
yT
yT
yT
yT
yT
yT
yT
yT
yT
yT
yT
yT
yT
yT
yT
yT
"}
(37,1,1) = {"
yT
yT
yT
yT
yT
yT
yT
yT
yT
yT
yT
yT
yT
yT
yT
yT
yT
yT
yT
yT
yT
yT
Bj
yT
yT
yT
yT
yT
yT
yT
yT
yT
yT
yT
yT
yT
yT
yT
yT
yT
"}
(38,1,1) = {"
yT
yT
yT
yT
yT
yT
yT
yT
yT
yT
yT
yT
yT
yT
yT
yT
yT
yT
yT
yT
yT
yT
yT
yT
yT
yT
yT
yT
yT
yT
yT
yT
yT
yT
yT
yT
yT
yT
yT
yT
"}
(39,1,1) = {"
yT
yT
yT
yT
yT
yT
yT
yT
yT
yT
yT
yT
yT
yT
yT
yT
yT
yT
yT
yT
yT
yT
yT
yT
yT
yT
yT
yT
yT
yT
yT
yT
yT
yT
yT
yT
yT
yT
yT
yT
"}
(40,1,1) = {"
yT
yT
yT
yT
yT
yT
yT
yT
yT
yT
yT
yT
yT
yT
yT
yT
yT
yT
yT
yT
yT
yT
yT
yT
yT
yT
yT
yT
yT
yT
yT
yT
yT
yT
yT
yT
yT
yT
yT
yT
"}
