//MAP CONVERTED BY dmm2tgm.py THIS HEADER COMMENT PREVENTS RECONVERSION, DO NOT REMOVE
"c" = (
/obj/structure/shuttle/engine/heater{
	dir = 1;
	tag = "icon-heater (NORTH)"
	},
/obj/structure/window/reinforced,
/turf/simulated/floor/plating/airless,
/area/space/nearstation)
"d" = (
/turf/space,
/turf/simulated/wall/shuttle{
	dir = 1;
	icon_state = "white_walls_directions"
	},
/area/space/nearstation)
"e" = (
/obj/machinery/door/airlock/titanium,
/turf/simulated/floor/plasteel/airless,
/area/space/nearstation)
"f" = (
/obj/item/broken_bottle,
/obj/effect/mob_spawn/human/mime/corpse,
/turf/simulated/floor/plasteel/airless,
/area/space/nearstation)
"g" = (
/obj/item/shard,
/obj/effect/mob_spawn/human/mime/corpse,
/turf/simulated/floor/plasteel/airless,
/area/space/nearstation)
"h" = (
/obj/item/shard{
	icon_state = "medium"
	},
/obj/effect/mob_spawn/human/mime/corpse,
/turf/simulated/floor/plasteel/airless,
/area/space/nearstation)
"j" = (
/obj/structure/closet/crate,
/obj/item/stack/ore/tranquillite,
/obj/item/stack/ore/tranquillite,
/obj/item/stack/ore/tranquillite,
/obj/item/stack/ore/tranquillite,
/obj/item/stack/ore/tranquillite,
/obj/item/stack/ore/tranquillite,
/obj/item/stack/ore/tranquillite,
/obj/item/stack/ore/tranquillite,
/turf/simulated/floor/plasteel/airless,
/area/space/nearstation)
"k" = (
/turf/simulated/floor/plasteel/airless,
/area/space/nearstation)
"m" = (
/turf/simulated/mineral,
/area/space/nearstation)
"n" = (
/turf/simulated/floor/plating/asteroid/airless,
/area/space/nearstation)
"p" = (
/obj/item/shard{
	icon_state = "small"
	},
/turf/simulated/floor/plating/asteroid/airless,
/area/space/nearstation)
"q" = (
/obj/structure/closet/crate,
/obj/item/stack/ore/tranquillite,
/obj/item/stack/ore/tranquillite,
/obj/item/stack/ore/tranquillite,
/obj/item/stack/ore/tranquillite,
/obj/item/stack/ore/tranquillite,
/obj/item/stack/ore/tranquillite,
/obj/item/stack/ore/tranquillite,
/turf/simulated/floor/plasteel/airless,
/area/space/nearstation)
"r" = (
/turf/template_noop,
/area/template_noop)
"s" = (
/obj/item/shard,
/turf/simulated/floor/plating/asteroid/airless,
/area/space/nearstation)
"t" = (
/obj/effect/mob_spawn/human/mime/corpse{
	name = "Mime Pilot"
	},
/turf/simulated/floor/plasteel/airless,
/area/space/nearstation)
"u" = (
/turf/simulated/wall/shuttle{
	dir = 1
	},
/area/space/nearstation)
"v" = (
/turf/simulated/wall/shuttle{
	dir = 4
	},
/area/space/nearstation)
"w" = (
/turf/space,
/turf/simulated/wall/shuttle{
	dir = 6;
	icon_state = "white_walls_directions"
	},
/area/space/nearstation)
"x" = (
/obj/effect/mob_spawn/human/clown/corpse,
/turf/simulated/floor/plasteel/airless,
/area/space/nearstation)
"y" = (
/obj/structure/closet/crate,
/obj/item/stack/ore/bananium,
/obj/item/stack/ore/bananium,
/obj/item/stack/ore/bananium,
/obj/item/stack/ore/bananium,
/obj/item/stack/ore/bananium,
/turf/simulated/floor/plasteel/airless,
/area/space/nearstation)
"z" = (
/obj/structure/closet/crate{
	icon_state = "crateopen";
	opened = 1
	},
/obj/item/stack/ore/bananium,
/obj/item/grenade/bananade,
/turf/simulated/floor/plasteel/airless,
/area/space/nearstation)
"A" = (
/obj/structure/shuttle/engine/heater{
	dir = 4;
	tag = "icon-heater (EAST)"
	},
/obj/structure/window/reinforced{
	dir = 8
	},
/turf/simulated/floor/plating/airless,
/area/space/nearstation)
"B" = (
/obj/structure/shuttle/engine/propulsion{
	dir = 4;
	icon_state = "propulsion_l";
	tag = "icon-propulsion_l (WEST)"
	},
/obj/structure/shuttle/engine/propulsion{
	dir = 4;
	icon_state = "burst_r";
	tag = "icon-burst_r (WEST)"
	},
/turf/simulated/floor/plating/airless,
/area/space/nearstation)
"C" = (
/obj/effect/mob_spawn/human/corpse/clownmili,
/turf/simulated/floor/plasteel/airless,
/area/space/nearstation)
"D" = (
/obj/item/stack/ore/bananium,
/turf/simulated/floor/plasteel/airless,
/area/space/nearstation)
"E" = (
/obj/structure/shuttle/engine/propulsion{
	dir = 4;
	icon_state = "propulsion_l";
	tag = "icon-propulsion_l (WEST)"
	},
/turf/simulated/floor/plating/airless,
/area/space/nearstation)
"F" = (
/obj/structure/computerframe/HONKputer,
/turf/simulated/floor/plasteel/airless,
/area/space/nearstation)
"G" = (
/obj/item/shard{
	icon_state = "medium"
	},
/obj/structure/chair/comfy/shuttle{
	dir = 8
	},
/turf/simulated/floor/plating/asteroid/airless,
/area/space/nearstation)
"H" = (
/obj/effect/mob_spawn/human/clown/corpse{
	name = "Clown Pilot"
	},
/turf/simulated/floor/plasteel/airless,
/area/space/nearstation)
"I" = (
/obj/item/paper/clownship,
/turf/simulated/floor/plasteel/airless,
/area/space/nearstation)
"J" = (
/obj/structure/grille,
/obj/structure/window/reinforced,
/obj/structure/window/reinforced{
	dir = 8
	},
/obj/structure/window/reinforced{
	dir = 4
	},
/turf/simulated/floor/plating/airless,
/area/space/nearstation)
"K" = (
/obj/item/shard,
/obj/structure/chair/comfy/shuttle{
	dir = 8
	},
/turf/simulated/floor/plasteel/airless,
/area/space/nearstation)
"L" = (
/obj/item/shard{
	icon_state = "medium"
	},
/turf/simulated/floor/plasteel/airless,
/area/space/nearstation)
"N" = (
/turf/space,
/turf/simulated/wall/shuttle{
	dir = 5;
	icon_state = "white_walls_directions"
	},
/area/space/nearstation)
"O" = (
/obj/effect/mob_spawn/human/corpse/clownoff,
/turf/simulated/floor/plasteel/airless,
/area/space/nearstation)
"P" = (
/obj/item/pickaxe,
/turf/simulated/floor/plasteel/airless,
/area/space/nearstation)
"Q" = (
/obj/structure/closet/crate,
/obj/item/stack/ore/bananium,
/obj/item/stack/ore/bananium,
/obj/item/stack/ore/bananium,
/obj/item/stack/ore/bananium,
/turf/simulated/floor/plasteel/airless,
/area/space/nearstation)
"R" = (
/obj/structure/shuttle/engine/propulsion{
	dir = 4;
	icon_state = "propulsion_l";
	tag = "icon-propulsion_l (WEST)"
	},
/obj/structure/shuttle/engine/propulsion{
	dir = 4;
	icon_state = "propulsion_l";
	tag = "icon-propulsion_l (WEST)"
	},
/turf/simulated/floor/plating/airless,
/area/space/nearstation)
"S" = (
/turf/space,
/turf/simulated/wall/shuttle{
	dir = 4
	},
/area/space/nearstation)
"U" = (
/turf/space,
/turf/simulated/wall/shuttle{
	dir = 9;
	icon_state = "white_walls_directions"
	},
/area/space/nearstation)
"V" = (
/turf/simulated/wall/shuttle{
	dir = 4;
	icon_state = "white_walls_directions"
	},
/area/space/nearstation)
"W" = (
/turf/space,
/turf/simulated/wall/shuttle{
	dir = 4;
	icon_state = "white_walls_directions"
	},
/area/space/nearstation)
"X" = (
/turf/simulated/wall/shuttle{
	dir = 8;
	icon_state = "white_walls_directions"
	},
/area/space/nearstation)

(1,1,1) = {"
r
r
r
r
m
m
r
r
r
r
r
r
r
r
r
r
r
r
r
r
"}
(2,1,1) = {"
r
r
r
m
m
m
m
m
r
r
r
r
r
r
m
m
r
r
r
r
"}
(3,1,1) = {"
r
r
r
m
m
m
m
m
m
r
m
m
m
m
m
m
r
r
r
r
"}
(4,1,1) = {"
r
r
r
r
m
m
m
m
m
m
m
m
m
m
m
r
r
r
r
r
"}
(5,1,1) = {"
r
r
r
r
r
m
m
m
m
m
m
m
m
m
m
m
m
m
m
r
"}
(6,1,1) = {"
r
r
r
r
r
m
m
m
m
m
m
m
m
m
m
m
m
m
r
r
"}
(7,1,1) = {"
r
r
r
r
m
m
m
m
m
m
m
m
m
m
m
m
m
r
r
r
"}
(8,1,1) = {"
r
r
r
n
m
m
m
m
m
m
m
m
m
m
m
m
m
r
r
r
"}
(9,1,1) = {"
r
r
r
n
m
m
m
m
m
m
m
m
m
m
m
m
n
r
r
r
"}
(10,1,1) = {"
d
e
u
u
m
m
m
m
m
m
m
m
m
m
m
n
n
r
r
r
"}
(11,1,1) = {"
c
f
j
p
m
m
m
m
m
m
m
m
m
m
m
n
n
n
r
r
"}
(12,1,1) = {"
c
g
k
q
s
n
m
m
m
m
m
m
m
m
m
m
m
n
n
r
"}
(13,1,1) = {"
c
h
j
q
t
n
m
m
m
m
m
m
m
m
m
m
m
m
m
r
"}
(14,1,1) = {"
d
e
u
u
u
m
m
n
m
m
m
m
m
m
m
m
m
n
m
r
"}
(15,1,1) = {"
r
r
r
r
m
m
m
n
n
m
m
m
m
m
m
m
m
m
m
m
"}
(16,1,1) = {"
r
r
r
r
m
r
r
r
S
m
m
J
m
m
m
m
m
m
m
m
"}
(17,1,1) = {"
r
r
r
r
r
r
r
r
v
m
F
k
v
m
m
m
m
n
m
m
"}
(18,1,1) = {"
r
r
r
r
r
r
r
U
w
m
G
K
N
m
m
m
m
n
m
m
"}
(19,1,1) = {"
r
r
r
r
r
r
r
v
n
p
H
k
O
v
m
m
m
n
n
n
"}
(20,1,1) = {"
r
r
r
r
r
r
r
V
x
C
k
L
P
V
m
m
m
r
r
r
"}
(21,1,1) = {"
r
r
r
r
r
r
r
e
k
k
I
k
k
e
m
m
r
r
r
r
"}
(22,1,1) = {"
r
r
r
r
r
r
r
e
k
k
D
x
k
e
m
m
r
r
r
r
"}
(23,1,1) = {"
r
r
r
r
r
r
r
X
y
k
k
k
Q
X
m
r
r
r
r
r
"}
(24,1,1) = {"
r
r
r
r
r
r
r
v
y
k
D
k
y
v
m
r
r
r
r
r
"}
(25,1,1) = {"
r
r
r
r
r
r
r
v
z
D
k
k
y
v
m
r
r
r
r
r
"}
(26,1,1) = {"
r
r
r
r
r
r
r
v
k
k
D
D
k
v
r
r
r
r
r
r
"}
(27,1,1) = {"
r
r
r
r
r
r
r
W
A
A
A
A
A
W
r
r
r
r
r
r
"}
(28,1,1) = {"
r
r
r
r
r
r
r
r
B
E
E
E
R
r
r
r
r
r
r
r
"}
