//MAP CONVERTED BY dmm2tgm.py THIS HEADER COMMENT PREVENTS RECONVERSION, DO NOT REMOVE
"a" = (
/turf/simulated/wall/rust,
/area/ruin/space/cluwne_ruin)
"c" = (
/obj/structure/table/wood/fancy/cyan,
/obj/item/clothing/mask/gas/clown_hat,
/turf/simulated/floor/noslip,
/area/ruin/space/cluwne_ruin)
"d" = (
/turf/simulated/floor/noslip,
/area/ruin/space/cluwne_ruin)
"e" = (
/obj/structure/table/wood/fancy/orange,
/obj/item/flashlight/lamp/bananalamp{
	base_pixel_y = 10;
	pixel_y = 10;
	light_on = 1
	},
/turf/simulated/floor/noslip,
/area/ruin/space/cluwne_ruin)
"f" = (
/obj/structure/table/wood/fancy/black,
/obj/item/retractor{
	pixel_y = 10
	},
/turf/simulated/floor/noslip,
/area/ruin/space/cluwne_ruin)
"g" = (
/obj/item/flag/clown,
/turf/simulated/floor/noslip,
/area/ruin/space/cluwne_ruin)
"h" = (
/obj/structure/fans/tiny,
/turf/simulated/floor/mineral/gold/fancy,
/area/ruin/space/cluwne_ruin)
"i" = (
/obj/item/flag/species/greys,
/turf/simulated/floor/noslip,
/area/ruin/space/cluwne_ruin)
"j" = (
/mob/living/simple_animal/hostile/retaliate/clown/goblin,
/turf/simulated/floor/noslip,
/area/ruin/space/cluwne_ruin)
"k" = (
/obj/structure/table/wood/fancy/orange,
/obj/item/toy/figure/clown,
/turf/simulated/floor/noslip,
/area/ruin/space/cluwne_ruin)
"l" = (
/turf/simulated/floor/mineral/gold/fancy,
/area/ruin/space/cluwne_ruin)
"m" = (
/obj/structure/table/wood/fancy/orange,
/obj/item/clothing/mask/gas/clown_hat,
/turf/simulated/floor/noslip,
/area/ruin/space/cluwne_ruin)
"n" = (
/obj/structure/table/wood/fancy/cyan,
/obj/item/bikehorn/golden{
	pixel_y = 10
	},
/turf/simulated/floor/noslip,
/area/ruin/space/cluwne_ruin)
"o" = (
/obj/structure/table/wood/fancy/green,
/obj/item/scalpel{
	pixel_y = 10
	},
/turf/simulated/floor/noslip,
/area/ruin/space/cluwne_ruin)
"p" = (
/obj/structure/sacrificealtar,
/obj/item/clothing/mask/cursedclown,
/turf/simulated/floor/mineral/uranium,
/area/ruin/space/cluwne_ruin/altair)
"q" = (
/obj/item/flag/species/unathi,
/turf/simulated/floor/noslip,
/area/ruin/space/cluwne_ruin)
"r" = (
/obj/item/flag/species/nian,
/turf/simulated/floor/noslip,
/area/ruin/space/cluwne_ruin)
"s" = (
/obj/structure/table/wood/fancy/black,
/turf/simulated/floor/noslip,
/area/ruin/space/cluwne_ruin)
"t" = (
/obj/item/candle/eternal{
	start_lit = 1
	},
/turf/simulated/floor/mineral/uranium,
/area/ruin/space/cluwne_ruin/altair)
"u" = (
/obj/structure/table/wood/fancy/black,
/obj/item/flashlight/lamp/bananalamp{
	base_pixel_y = 10;
	pixel_y = 10;
	light_on = 1
	},
/turf/simulated/floor/noslip,
/area/ruin/space/cluwne_ruin)
"w" = (
/obj/item/candle/eternal{
	start_lit = 1
	},
/turf/simulated/floor/noslip,
/area/ruin/space/cluwne_ruin)
"x" = (
/obj/structure/table/wood/fancy/green,
/turf/simulated/floor/noslip,
/area/ruin/space/cluwne_ruin)
"z" = (
/obj/structure/mineral_door/uranium,
/turf/simulated/floor/mineral/uranium,
/area/ruin/space/cluwne_ruin/altair)
"A" = (
/obj/structure/table/wood/fancy/orange,
/obj/item/reagent_containers/food/snacks/bananacakeslice,
/turf/simulated/floor/noslip,
/area/ruin/space/cluwne_ruin)
"B" = (
/obj/structure/table/wood/fancy/cyan,
/obj/item/flashlight/lamp/bananalamp{
	base_pixel_y = 10;
	pixel_y = 10;
	light_on = 1
	},
/turf/simulated/floor/noslip,
/area/ruin/space/cluwne_ruin)
"C" = (
/mob/living/simple_animal/hostile/retaliate/clown/goblin,
/turf/simulated/floor/mineral/gold/fancy,
/area/ruin/space/cluwne_ruin)
"D" = (
/obj/structure/window/reinforced/tinted{
	dir = 4
	},
/turf/simulated/floor/mineral/gold/fancy,
/area/ruin/space/cluwne_ruin)
"E" = (
/obj/structure/window/reinforced/tinted,
/mob/living/simple_animal/hostile/retaliate/clown/goblin,
/turf/simulated/floor/mineral/gold/fancy,
/area/ruin/space/cluwne_ruin)
"F" = (
/mob/living/simple_animal/hostile/retaliate/clown,
/turf/simulated/floor/noslip,
/area/ruin/space/cluwne_ruin)
"H" = (
/obj/structure/window/reinforced/tinted,
/turf/simulated/floor/mineral/gold/fancy,
/area/ruin/space/cluwne_ruin)
"J" = (
/turf/simulated/floor/mineral/uranium,
/area/ruin/space/cluwne_ruin/altair)
"L" = (
/obj/effect/decal/cleanable/confetti,
/turf/simulated/floor/mineral/gold/fancy,
/area/ruin/space/cluwne_ruin)
"M" = (
/turf/simulated/wall/mineral/uranium,
/area/ruin/space/cluwne_ruin/altair)
"N" = (
/obj/structure/table/wood/fancy/orange,
/turf/simulated/floor/noslip,
/area/ruin/space/cluwne_ruin)
"P" = (
/obj/structure/table/wood/fancy/cyan,
/turf/simulated/floor/noslip,
/area/ruin/space/cluwne_ruin)
"Q" = (
/obj/structure/window/reinforced/tinted{
	dir = 1
	},
/turf/simulated/floor/mineral/gold/fancy,
/area/ruin/space/cluwne_ruin)
"R" = (
/obj/structure/statue/bananium/clown,
/turf/simulated/floor/mineral/bananium,
/area/ruin/space/cluwne_ruin)
"S" = (
/obj/structure/window/reinforced/tinted{
	dir = 8
	},
/turf/simulated/floor/mineral/gold/fancy,
/area/ruin/space/cluwne_ruin)
"T" = (
/obj/structure/table/wood/fancy/green,
/obj/item/flashlight/lamp/bananalamp{
	base_pixel_y = 10;
	pixel_y = 10;
	light_on = 1
	},
/turf/simulated/floor/noslip,
/area/ruin/space/cluwne_ruin)
"U" = (
/obj/effect/decal/cleanable/confetti,
/turf/simulated/floor/noslip,
/area/ruin/space/cluwne_ruin)
"V" = (
/obj/structure/table/wood/fancy/green,
/obj/item/clothing/mask/gas/clown_hat/sexy,
/turf/simulated/floor/noslip,
/area/ruin/space/cluwne_ruin)
"W" = (
/obj/effect/decal/cleanable/confetti,
/mob/living/simple_animal/hostile/retaliate/clown/goblin,
/turf/simulated/floor/noslip,
/area/ruin/space/cluwne_ruin)
"X" = (
/obj/structure/table/wood/fancy/black,
/obj/item/clothing/mask/gas/clown_hat/joker,
/turf/simulated/floor/noslip,
/area/ruin/space/cluwne_ruin)
"Y" = (
/obj/item/flag/species/human,
/turf/simulated/floor/noslip,
/area/ruin/space/cluwne_ruin)
"Z" = (
/turf/space,
/area/space)

(1,1,1) = {"
Z
Z
Z
Z
Z
Z
Z
Z
Z
Z
Z
Z
Z
Z
Z
Z
Z
Z
Z
Z
Z
Z
Z
Z
Z
Z
Z
Z
Z
Z
"}
(2,1,1) = {"
Z
Z
Z
Z
Z
Z
Z
Z
Z
Z
Z
Z
Z
Z
Z
Z
Z
Z
Z
Z
Z
Z
Z
Z
Z
Z
Z
Z
Z
Z
"}
(3,1,1) = {"
Z
Z
Z
Z
Z
Z
Z
Z
Z
Z
Z
Z
Z
Z
Z
Z
Z
Z
Z
Z
Z
Z
Z
Z
Z
Z
Z
Z
Z
Z
"}
(4,1,1) = {"
Z
Z
Z
Z
Z
Z
Z
Z
Z
Z
Z
Z
Z
Z
Z
Z
Z
Z
Z
Z
Z
Z
Z
Z
Z
Z
Z
Z
Z
Z
"}
(5,1,1) = {"
Z
Z
Z
Z
Z
Z
Z
Z
Z
Z
Z
Z
Z
Z
Z
Z
Z
Z
Z
Z
Z
Z
Z
Z
Z
Z
Z
Z
Z
Z
"}
(6,1,1) = {"
Z
Z
Z
Z
Z
Z
Z
Z
Z
Z
Z
Z
Z
Z
Z
Z
Z
Z
Z
Z
Z
Z
Z
Z
Z
Z
Z
Z
Z
Z
"}
(7,1,1) = {"
Z
Z
Z
Z
Z
Z
Z
Z
Z
Z
Z
Z
Z
Z
Z
Z
Z
Z
Z
Z
Z
Z
Z
Z
Z
Z
Z
Z
Z
Z
"}
(8,1,1) = {"
Z
Z
Z
Z
Z
Z
Z
Z
a
a
a
Z
Z
Z
Z
Z
Z
Z
Z
Z
Z
Z
a
a
a
Z
Z
Z
Z
Z
"}
(9,1,1) = {"
Z
Z
Z
Z
Z
Z
Z
Z
a
r
w
a
a
a
a
a
h
a
a
a
a
a
w
q
a
Z
Z
Z
Z
Z
"}
(10,1,1) = {"
Z
Z
Z
Z
Z
Z
Z
Z
a
w
U
d
F
d
d
l
l
l
d
d
d
F
d
w
a
Z
Z
Z
Z
Z
"}
(11,1,1) = {"
Z
Z
Z
Z
Z
Z
Z
Z
Z
a
d
e
m
k
d
l
D
l
W
P
c
B
d
a
Z
Z
Z
Z
Z
Z
"}
(12,1,1) = {"
Z
Z
Z
Z
Z
Z
Z
Z
Z
a
d
A
g
d
d
H
R
Q
d
d
g
n
d
a
Z
Z
Z
Z
Z
Z
"}
(13,1,1) = {"
Z
Z
Z
Z
Z
Z
Z
Z
Z
a
d
N
d
d
C
l
S
l
l
d
d
P
d
a
Z
Z
Z
Z
Z
Z
"}
(14,1,1) = {"
Z
Z
Z
Z
Z
Z
Z
Z
Z
a
d
d
d
l
M
M
z
M
M
l
d
d
d
a
Z
Z
Z
Z
Z
Z
"}
(15,1,1) = {"
Z
Z
Z
Z
Z
Z
Z
Z
Z
h
l
l
D
l
M
J
t
J
M
l
D
l
l
h
Z
Z
Z
Z
Z
Z
"}
(16,1,1) = {"
Z
Z
Z
Z
Z
Z
Z
Z
Z
h
L
H
R
Q
z
t
p
t
z
H
R
Q
l
h
Z
Z
Z
Z
Z
Z
"}
(17,1,1) = {"
Z
Z
Z
Z
Z
Z
Z
Z
Z
h
l
l
S
l
M
J
t
J
M
l
S
l
l
h
Z
Z
Z
Z
Z
Z
"}
(18,1,1) = {"
Z
Z
Z
Z
Z
Z
Z
Z
Z
a
d
d
d
l
M
M
z
M
M
l
U
d
d
a
Z
Z
Z
Z
Z
Z
"}
(19,1,1) = {"
Z
Z
Z
Z
Z
Z
Z
Z
Z
a
d
s
j
U
l
l
D
l
l
j
d
x
d
a
Z
Z
Z
Z
Z
Z
"}
(20,1,1) = {"
Z
Z
Z
Z
Z
Z
Z
Z
Z
a
d
X
g
d
d
E
R
Q
d
d
g
o
d
a
Z
Z
Z
Z
Z
Z
"}
(21,1,1) = {"
Z
Z
Z
Z
Z
Z
Z
Z
Z
a
F
u
f
s
d
l
S
l
U
x
T
V
F
a
Z
Z
Z
Z
Z
Z
"}
(22,1,1) = {"
Z
Z
Z
Z
Z
Z
Z
Z
a
w
d
d
d
d
d
d
l
d
d
d
d
d
d
w
a
Z
Z
Z
Z
Z
"}
(23,1,1) = {"
Z
Z
Z
Z
Z
Z
Z
Z
a
Y
w
a
a
a
a
a
h
a
a
a
a
a
w
i
a
Z
Z
Z
Z
Z
"}
(24,1,1) = {"
Z
Z
Z
Z
Z
Z
Z
Z
a
a
a
Z
Z
Z
Z
Z
Z
Z
Z
Z
Z
Z
a
a
a
Z
Z
Z
Z
Z
"}
(25,1,1) = {"
Z
Z
Z
Z
Z
Z
Z
Z
Z
Z
Z
Z
Z
Z
Z
Z
Z
Z
Z
Z
Z
Z
Z
Z
Z
Z
Z
Z
Z
Z
"}
(26,1,1) = {"
Z
Z
Z
Z
Z
Z
Z
Z
Z
Z
Z
Z
Z
Z
Z
Z
Z
Z
Z
Z
Z
Z
Z
Z
Z
Z
Z
Z
Z
Z
"}
(27,1,1) = {"
Z
Z
Z
Z
Z
Z
Z
Z
Z
Z
Z
Z
Z
Z
Z
Z
Z
Z
Z
Z
Z
Z
Z
Z
Z
Z
Z
Z
Z
Z
"}
(28,1,1) = {"
Z
Z
Z
Z
Z
Z
Z
Z
Z
Z
Z
Z
Z
Z
Z
Z
Z
Z
Z
Z
Z
Z
Z
Z
Z
Z
Z
Z
Z
Z
"}
(29,1,1) = {"
Z
Z
Z
Z
Z
Z
Z
Z
Z
Z
Z
Z
Z
Z
Z
Z
Z
Z
Z
Z
Z
Z
Z
Z
Z
Z
Z
Z
Z
Z
"}
(30,1,1) = {"
Z
Z
Z
Z
Z
Z
Z
Z
Z
Z
Z
Z
Z
Z
Z
Z
Z
Z
Z
Z
Z
Z
Z
Z
Z
Z
Z
Z
Z
Z
"}
