//MAP CONVERTED BY dmm2tgm.py THIS HEADER COMMENT PREVENTS RECONVERSION, DO NOT REMOVE
"a" = (
/turf/template_noop,
/area/template_noop)
"b" = (
/obj/structure/window/reinforced{
	tag = "icon-rwindow (EAST)";
	dir = 4
	},
/turf/space,
/area/space/nearstation)
"c" = (
/obj/machinery/door/airlock/external,
/turf/simulated/floor/plating,
/area/ruin/powered)
"d" = (
/obj/structure/window/reinforced{
	tag = "icon-rwindow (WEST)";
	dir = 8
	},
/turf/space,
/area/space/nearstation)
"e" = (
/obj/structure/window/reinforced{
	tag = "icon-rwindow (EAST)";
	dir = 4
	},
/obj/structure/window/reinforced{
	tag = "icon-rwindow (WEST)";
	dir = 8
	},
/turf/simulated/floor/plating,
/area/ruin/powered)
"f" = (
/turf/simulated/wall,
/area/ruin/powered)
"g" = (
/obj/structure/grille,
/obj/structure/window/full/reinforced,
/turf/simulated/floor/plating,
/area/ruin/powered)
"h" = (
/obj/machinery/light/small{
	tag = "icon-bulb1 (NORTH)";
	dir = 1
	},
/turf/simulated/floor/plasteel,
/area/ruin/powered)
"i" = (
/turf/simulated/floor/plasteel,
/area/ruin/powered)
"j" = (
/obj/machinery/light/small{
	tag = "icon-bulb1 (EAST)";
	dir = 4
	},
/turf/simulated/floor/plasteel,
/area/ruin/powered)
"k" = (
/obj/structure/window/reinforced,
/turf/space,
/area/space/nearstation)
"l" = (
/obj/structure/window/reinforced,
/obj/structure/window/reinforced{
	tag = "icon-rwindow (NORTH)";
	dir = 1
	},
/turf/simulated/floor/plating,
/area/ruin/powered)
"m" = (
/obj/structure/chair{
	tag = "icon-chair (EAST)";
	dir = 4
	},
/obj/effect/decal/remains/human,
/turf/simulated/floor/plasteel,
/area/ruin/powered)
"n" = (
/obj/structure/table,
/obj/item/candle{
	pixel_y = 5
	},
/obj/item/trash/plate{
	pixel_x = 10
	},
/obj/item/trash/plate{
	pixel_x = -10
	},
/turf/simulated/floor/plasteel,
/area/ruin/powered)
"o" = (
/obj/structure/chair{
	tag = "icon-chair (WEST)";
	dir = 8
	},
/obj/effect/decal/remains/human,
/turf/simulated/floor/plasteel,
/area/ruin/powered)
"p" = (
/obj/structure/window/reinforced{
	tag = "icon-rwindow (NORTH)";
	dir = 1
	},
/turf/space,
/area/space/nearstation)
"q" = (
/obj/machinery/light/small{
	tag = "icon-bulb1 (WEST)";
	dir = 8
	},
/turf/simulated/floor/plasteel,
/area/ruin/powered)
"r" = (
/obj/machinery/light/small,
/turf/simulated/floor/plasteel,
/area/ruin/powered)
"J" = (
/turf/space,
/area/space)

(1,1,1) = {"
a
a
a
a
a
a
a
a
a
a
a
a
a
a
a
a
a
a
a
a
a
a
a
a
a
a
a
a
a
a
a
a
a
a
a
a
a
a
a
a
"}
(2,1,1) = {"
a
a
a
a
a
a
a
a
a
a
a
a
a
a
a
a
a
a
a
a
a
a
a
a
a
a
a
a
a
a
a
a
a
a
a
a
a
a
a
a
"}
(3,1,1) = {"
a
a
a
a
a
a
a
a
a
a
a
a
a
a
a
a
a
a
a
a
a
a
a
a
a
a
a
a
a
a
a
a
a
a
a
a
a
a
a
a
"}
(4,1,1) = {"
a
a
a
J
J
J
J
J
J
J
J
J
J
J
J
J
J
J
J
J
J
J
J
J
J
J
J
J
J
J
J
J
J
J
J
J
J
a
a
a
"}
(5,1,1) = {"
a
a
a
J
J
J
J
J
J
J
J
J
J
J
J
J
J
J
J
J
J
J
J
J
J
J
J
J
J
J
J
J
J
J
J
J
J
a
a
a
"}
(6,1,1) = {"
a
a
a
J
J
J
J
J
J
J
J
J
J
J
J
J
J
J
J
J
J
J
J
J
J
J
J
J
J
J
J
J
J
J
J
J
J
a
a
a
"}
(7,1,1) = {"
a
a
a
J
J
J
J
J
J
J
J
J
J
J
J
J
J
J
J
J
J
J
J
J
J
J
J
J
J
J
J
J
J
J
J
J
J
a
a
a
"}
(8,1,1) = {"
a
a
a
J
J
J
J
J
J
J
J
J
J
J
J
J
J
J
J
J
J
J
J
J
J
J
J
J
J
J
J
J
J
J
J
J
J
a
a
a
"}
(9,1,1) = {"
a
a
a
J
J
J
J
J
J
J
J
J
J
J
J
J
J
J
J
J
J
J
J
J
J
J
J
J
J
J
J
J
J
J
J
J
J
a
a
a
"}
(10,1,1) = {"
a
a
a
J
J
J
J
J
J
J
J
J
J
J
J
J
J
J
J
J
J
J
J
J
J
J
J
J
J
J
J
J
J
J
J
J
J
a
a
a
"}
(11,1,1) = {"
a
a
a
J
J
J
J
J
J
J
J
J
J
J
J
J
J
J
J
J
J
J
J
J
J
J
J
J
J
J
J
J
J
J
J
J
J
a
a
a
"}
(12,1,1) = {"
a
a
a
J
J
J
J
J
J
J
J
J
J
J
J
J
J
J
k
c
p
J
J
J
J
J
J
J
J
J
J
J
J
J
J
J
J
a
a
a
"}
(13,1,1) = {"
a
a
a
J
J
J
J
J
J
J
J
J
J
J
J
J
J
J
k
l
p
J
J
J
J
J
J
J
J
J
J
J
J
J
J
J
J
a
a
a
"}
(14,1,1) = {"
a
a
a
J
J
J
J
J
J
J
J
J
J
J
J
J
J
J
k
l
p
J
J
J
J
J
J
J
J
J
J
J
J
J
J
J
J
a
a
a
"}
(15,1,1) = {"
a
a
a
J
J
J
J
J
J
J
J
J
J
J
J
J
J
J
k
l
p
J
J
J
J
J
J
J
J
J
J
J
J
J
J
J
J
a
a
a
"}
(16,1,1) = {"
a
a
a
J
J
J
J
J
J
J
J
J
J
J
J
J
J
f
g
c
g
f
J
J
J
J
J
J
J
J
J
J
J
J
J
J
J
a
a
a
"}
(17,1,1) = {"
a
a
a
J
J
J
J
J
J
J
J
J
J
J
J
J
f
f
i
i
i
f
f
J
J
J
J
J
J
J
J
J
J
J
J
J
J
a
a
a
"}
(18,1,1) = {"
a
a
a
J
J
J
J
J
J
J
J
J
J
J
J
f
f
i
i
i
i
q
f
f
J
J
J
J
J
J
J
J
J
J
J
J
J
a
a
a
"}
(19,1,1) = {"
a
a
a
J
J
J
J
J
J
J
J
J
J
J
f
f
h
i
i
i
i
i
i
f
f
J
J
J
J
J
J
J
J
J
J
J
J
a
a
a
"}
(20,1,1) = {"
a
a
a
J
J
J
J
J
J
J
b
b
b
b
g
i
i
i
i
m
i
i
i
i
g
b
b
b
b
J
J
J
J
J
J
J
J
a
a
a
"}
(21,1,1) = {"
a
a
a
J
J
J
J
J
J
J
c
e
e
e
c
i
i
i
i
n
i
i
i
i
c
e
e
e
c
J
J
J
J
J
J
J
J
a
a
a
"}
(22,1,1) = {"
a
a
a
J
J
J
J
J
J
J
d
d
d
d
g
i
i
i
i
o
i
i
i
i
g
d
d
d
d
J
J
J
J
J
J
J
J
a
a
a
"}
(23,1,1) = {"
a
a
a
J
J
J
J
J
J
J
J
J
J
J
f
f
i
i
i
i
i
i
r
f
f
J
J
J
J
J
J
J
J
J
J
J
J
a
a
a
"}
(24,1,1) = {"
a
a
a
J
J
J
J
J
J
J
J
J
J
J
J
f
f
j
i
i
i
i
f
f
J
J
J
J
J
J
J
J
J
J
J
J
J
a
a
a
"}
(25,1,1) = {"
a
a
a
J
J
J
J
J
J
J
J
J
J
J
J
J
f
f
i
i
i
f
f
J
J
J
J
J
J
J
J
J
J
J
J
J
J
a
a
a
"}
(26,1,1) = {"
a
a
a
J
J
J
J
J
J
J
J
J
J
J
J
J
J
f
g
c
g
f
J
J
J
J
J
J
J
J
J
J
J
J
J
J
J
a
a
a
"}
(27,1,1) = {"
a
a
a
J
J
J
J
J
J
J
J
J
J
J
J
J
J
J
k
l
p
J
J
J
J
J
J
J
J
J
J
J
J
J
J
J
J
a
a
a
"}
(28,1,1) = {"
a
a
a
J
J
J
J
J
J
J
J
J
J
J
J
J
J
J
k
l
p
J
J
J
J
J
J
J
J
J
J
J
J
J
J
J
J
a
a
a
"}
(29,1,1) = {"
a
a
a
J
J
J
J
J
J
J
J
J
J
J
J
J
J
J
k
l
p
J
J
J
J
J
J
J
J
J
J
J
J
J
J
J
J
a
a
a
"}
(30,1,1) = {"
a
a
a
J
J
J
J
J
J
J
J
J
J
J
J
J
J
J
k
c
p
J
J
J
J
J
J
J
J
J
J
J
J
J
J
J
J
a
a
a
"}
(31,1,1) = {"
a
a
a
J
J
J
J
J
J
J
J
J
J
J
J
J
J
J
J
J
J
J
J
J
J
J
J
J
J
J
J
J
J
J
J
J
J
a
a
a
"}
(32,1,1) = {"
a
a
a
J
J
J
J
J
J
J
J
J
J
J
J
J
J
J
J
J
J
J
J
J
J
J
J
J
J
J
J
J
J
J
J
J
J
a
a
a
"}
(33,1,1) = {"
a
a
a
J
J
J
J
J
J
J
J
J
J
J
J
J
J
J
J
J
J
J
J
J
J
J
J
J
J
J
J
J
J
J
J
J
J
a
a
a
"}
(34,1,1) = {"
a
a
a
J
J
J
J
J
J
J
J
J
J
J
J
J
J
J
J
J
J
J
J
J
J
J
J
J
J
J
J
J
J
J
J
J
J
a
a
a
"}
(35,1,1) = {"
a
a
a
J
J
J
J
J
J
J
J
J
J
J
J
J
J
J
J
J
J
J
J
J
J
J
J
J
J
J
J
J
J
J
J
J
J
a
a
a
"}
(36,1,1) = {"
a
a
a
J
J
J
J
J
J
J
J
J
J
J
J
J
J
J
J
J
J
J
J
J
J
J
J
J
J
J
J
J
J
J
J
J
J
a
a
a
"}
(37,1,1) = {"
a
a
a
J
J
J
J
J
J
J
J
J
J
J
J
J
J
J
J
J
J
J
J
J
J
J
J
J
J
J
J
J
J
J
J
J
J
a
a
a
"}
(38,1,1) = {"
a
a
a
a
a
a
a
a
a
a
a
a
a
a
a
a
a
a
a
a
a
a
a
a
a
a
a
a
a
a
a
a
a
a
a
a
a
a
a
a
"}
(39,1,1) = {"
a
a
a
a
a
a
a
a
a
a
a
a
a
a
a
a
a
a
a
a
a
a
a
a
a
a
a
a
a
a
a
a
a
a
a
a
a
a
a
a
"}
(40,1,1) = {"
a
a
a
a
a
a
a
a
a
a
a
a
a
a
a
a
a
a
a
a
a
a
a
a
a
a
a
a
a
a
a
a
a
a
a
a
a
a
a
a
"}
