//MAP CONVERTED BY dmm2tgm.py THIS HEADER COMMENT PREVENTS RECONVERSION, DO NOT REMOVE
"a" = (
/turf/template_noop,
/area/template_noop)
"b" = (
/turf/simulated/mineral,
/area/ruin/unpowered)
"c" = (
/turf/space,
/area/space)
"d" = (
/turf/simulated/floor/plating/asteroid/airless,
/area/ruin/unpowered)
"e" = (
/turf/simulated/wall,
/area/ruin/unpowered)
"f" = (
/turf/simulated/wall/rust,
/area/ruin/unpowered)
"g" = (
/turf/simulated/floor/plating/airless,
/area/ruin/unpowered)
"h" = (
/obj/structure/table,
/turf/simulated/floor/plating/airless,
/area/ruin/unpowered)
"i" = (
/obj/effect/decal/remains/human,
/turf/simulated/floor/plating/airless,
/area/ruin/unpowered)
"j" = (
/obj/machinery/door/airlock/external,
/turf/simulated/floor/plating/airless,
/area/ruin/unpowered)
"k" = (
/obj/effect/spawner/lootdrop/crate_spawner,
/turf/simulated/floor/plating/airless,
/area/ruin/unpowered)
"l" = (
/turf/simulated/mineral,
/area/space)
"m" = (
/obj/structure/table,
/obj/item/storage/toolbox/electrical,
/turf/simulated/floor/plating/airless,
/area/ruin/unpowered)
"n" = (
/obj/structure/barricade/wooden,
/obj/structure/door_assembly,
/turf/simulated/floor/plating/airless,
/area/ruin/unpowered)
"o" = (
/obj/structure/barricade/wooden,
/turf/simulated/floor/plating/airless,
/area/ruin/unpowered)
"p" = (
/obj/structure/barricade/wooden,
/obj/machinery/door/airlock/external,
/turf/simulated/floor/plating/asteroid/airless,
/area/ruin/unpowered)
"q" = (
/obj/structure/closet/crate,
/turf/simulated/floor/plating/airless,
/area/ruin/unpowered)
"r" = (
/obj/structure/table,
/obj/item/storage/toolbox/syndicate,
/turf/simulated/floor/plating/airless,
/area/ruin/unpowered)

(1,1,1) = {"
a
a
a
a
a
a
a
a
a
a
a
a
a
a
a
a
a
a
a
a
a
a
a
a
a
a
a
a
a
a
a
a
a
a
a
a
a
a
a
a
"}
(2,1,1) = {"
a
a
a
a
a
a
a
a
a
a
a
a
a
a
a
a
a
a
a
a
a
a
a
a
a
a
a
a
a
a
a
a
a
a
a
a
a
a
a
a
"}
(3,1,1) = {"
a
a
c
c
c
c
c
c
c
c
c
c
c
c
c
c
c
c
c
c
c
c
c
c
c
c
c
c
c
c
c
c
c
c
c
c
c
c
a
a
"}
(4,1,1) = {"
a
a
c
c
c
c
c
c
c
c
c
c
c
c
c
c
c
c
l
c
c
c
c
c
c
c
c
c
c
c
c
c
c
c
c
c
c
c
a
a
"}
(5,1,1) = {"
a
a
c
c
c
c
c
c
c
c
c
c
c
c
c
c
c
c
c
c
c
c
c
c
c
c
c
c
c
c
c
c
c
c
c
c
c
c
a
a
"}
(6,1,1) = {"
a
a
c
c
c
c
c
c
c
d
d
d
d
c
c
c
c
c
c
c
c
c
l
c
c
c
c
c
c
c
c
c
c
c
c
c
c
c
a
a
"}
(7,1,1) = {"
a
a
c
c
c
c
c
d
d
d
d
d
d
c
c
c
c
c
c
c
c
c
c
c
c
c
c
c
c
c
c
c
c
c
c
c
c
c
a
a
"}
(8,1,1) = {"
a
a
c
c
c
c
b
b
b
b
b
d
d
d
d
c
c
c
c
c
c
c
c
c
l
l
l
c
c
c
c
c
c
c
c
c
c
c
a
a
"}
(9,1,1) = {"
a
a
c
c
c
b
b
b
b
b
b
d
d
d
d
d
d
d
c
c
c
c
c
c
l
l
l
c
c
c
c
c
c
c
c
c
c
c
a
a
"}
(10,1,1) = {"
a
a
c
c
c
b
b
b
b
b
b
b
b
b
d
d
d
d
d
c
c
c
c
c
c
l
l
l
l
c
c
c
c
c
c
c
c
c
a
a
"}
(11,1,1) = {"
a
a
c
c
c
b
b
b
b
b
b
b
b
b
b
b
b
d
d
c
c
c
c
c
c
l
l
l
l
c
c
c
c
c
c
c
c
c
a
a
"}
(12,1,1) = {"
a
a
c
c
b
b
b
b
b
b
b
b
b
b
b
b
b
d
d
d
d
c
c
c
c
c
c
c
c
c
c
c
c
c
c
c
c
c
a
a
"}
(13,1,1) = {"
a
a
c
c
b
b
b
b
b
b
b
b
b
b
b
b
b
b
d
d
d
c
c
c
c
c
c
c
c
c
c
c
c
c
c
c
c
c
a
a
"}
(14,1,1) = {"
a
a
c
c
b
b
b
b
b
b
b
b
b
b
b
b
b
b
d
d
d
d
d
c
c
c
c
c
c
c
c
c
c
c
c
c
c
c
a
a
"}
(15,1,1) = {"
a
a
c
c
b
b
b
b
b
b
b
f
f
e
f
e
e
e
b
b
d
d
d
c
c
c
c
c
c
c
c
c
c
c
c
c
c
c
a
a
"}
(16,1,1) = {"
a
a
c
c
b
b
b
b
b
b
g
k
k
i
g
f
g
g
b
b
d
d
d
c
c
c
c
c
c
c
c
c
c
c
c
c
c
c
a
a
"}
(17,1,1) = {"
a
a
c
c
c
c
b
b
b
e
g
g
g
g
q
f
g
g
e
b
d
d
d
c
c
c
c
c
c
c
c
c
c
c
c
c
c
c
a
a
"}
(18,1,1) = {"
a
a
c
c
c
c
b
b
b
e
g
g
m
r
k
e
g
g
b
b
d
d
d
d
c
c
c
c
c
c
b
b
b
c
c
c
c
c
a
a
"}
(19,1,1) = {"
a
a
c
c
c
c
b
b
b
f
e
n
f
f
e
e
d
k
e
b
b
b
d
d
d
d
d
c
c
c
b
b
b
b
b
c
c
c
a
a
"}
(20,1,1) = {"
a
a
c
c
c
c
c
b
b
b
g
g
k
q
k
e
g
g
f
b
b
b
d
d
d
d
d
d
d
d
d
d
b
b
b
c
c
c
a
a
"}
(21,1,1) = {"
a
a
c
c
c
c
c
b
b
b
g
g
g
g
g
e
g
d
f
b
b
b
d
d
d
d
d
d
d
d
d
d
b
b
b
b
b
c
a
a
"}
(22,1,1) = {"
a
a
c
c
c
c
c
b
b
e
g
g
g
g
g
n
g
g
e
b
b
b
d
d
d
d
d
d
d
d
d
d
d
d
b
b
b
c
a
a
"}
(23,1,1) = {"
a
a
c
c
c
c
c
c
b
e
q
q
g
h
g
e
g
d
e
e
e
b
d
d
d
d
d
d
d
d
d
d
d
d
b
b
b
b
a
a
"}
(24,1,1) = {"
a
a
c
c
c
c
c
c
b
b
f
f
n
f
g
e
d
o
p
o
j
d
d
d
d
d
d
d
d
d
d
d
d
d
b
b
b
b
a
a
"}
(25,1,1) = {"
a
a
l
c
c
c
c
c
c
b
k
q
g
f
k
e
e
b
e
e
e
b
d
d
d
d
d
d
d
d
d
d
d
d
b
b
b
b
a
a
"}
(26,1,1) = {"
a
a
c
c
c
c
c
c
c
b
b
e
f
e
b
b
b
b
b
b
b
b
d
d
d
d
d
d
d
d
d
d
d
d
d
b
b
b
a
a
"}
(27,1,1) = {"
a
a
c
l
l
c
c
c
c
b
b
b
b
b
b
b
b
b
b
b
b
b
b
b
b
d
d
d
d
d
d
d
d
d
d
d
b
b
a
a
"}
(28,1,1) = {"
a
a
l
l
l
c
c
c
c
b
b
b
b
b
b
b
b
b
b
b
b
b
b
b
b
b
d
d
d
d
d
d
d
d
d
d
b
b
a
a
"}
(29,1,1) = {"
a
a
l
l
l
l
c
c
c
b
b
b
b
b
b
b
b
b
b
b
b
b
b
b
b
b
d
d
d
d
d
d
d
d
d
d
b
b
a
a
"}
(30,1,1) = {"
a
a
c
l
l
l
c
c
c
b
b
b
b
b
b
b
b
b
b
b
b
b
b
b
b
d
d
d
d
d
d
d
d
d
d
d
b
b
a
a
"}
(31,1,1) = {"
a
a
l
c
c
c
c
c
c
c
b
b
b
b
b
b
b
b
b
b
b
b
b
b
b
d
d
d
d
d
d
d
d
d
b
b
b
b
a
a
"}
(32,1,1) = {"
a
a
l
c
c
c
c
c
c
c
b
b
b
b
b
b
b
b
b
b
b
b
b
b
b
b
d
d
d
d
d
d
d
d
b
b
b
c
a
a
"}
(33,1,1) = {"
a
a
c
c
c
c
l
c
c
c
c
c
b
b
b
b
b
b
b
b
b
b
b
b
b
b
d
d
d
d
d
d
b
b
b
b
b
c
a
a
"}
(34,1,1) = {"
a
a
c
c
c
c
c
c
l
c
c
c
b
b
b
b
b
b
b
b
b
b
b
b
b
b
b
b
b
b
d
d
b
b
b
b
b
c
a
a
"}
(35,1,1) = {"
a
a
c
c
c
c
c
c
c
c
c
c
c
c
b
b
b
b
b
b
b
b
b
b
b
b
b
b
b
b
b
b
b
b
b
b
c
c
a
a
"}
(36,1,1) = {"
a
a
c
c
c
c
c
c
c
c
c
c
c
c
b
b
b
b
b
b
b
b
b
b
b
b
b
b
b
b
b
b
b
b
b
b
c
c
a
a
"}
(37,1,1) = {"
a
a
c
c
c
c
c
c
c
c
c
c
c
c
c
c
c
c
c
b
b
b
b
b
b
b
b
b
b
b
b
b
b
b
b
b
c
c
a
a
"}
(38,1,1) = {"
a
a
c
c
c
c
c
c
c
c
c
c
c
c
c
c
c
c
c
c
c
c
c
c
c
c
b
b
b
b
b
b
b
c
c
c
c
c
a
a
"}
(39,1,1) = {"
a
a
a
a
a
a
a
a
a
a
a
a
a
a
a
a
a
a
a
a
a
a
a
a
a
a
a
a
a
a
a
a
a
a
a
a
a
a
a
a
"}
(40,1,1) = {"
a
a
a
a
a
a
a
a
a
a
a
a
a
a
a
a
a
a
a
a
a
a
a
a
a
a
a
a
a
a
a
a
a
a
a
a
a
a
a
a
"}
