//MAP CONVERTED BY dmm2tgm.py THIS HEADER COMMENT PREVENTS RECONVERSION, DO NOT REMOVE
"a" = (
/turf/template_noop,
/area/template_noop)
"b" = (
/turf/simulated/mineral,
/area/ruin/unpowered)
"c" = (
/turf/simulated/floor/plating/asteroid/airless,
/area/ruin/unpowered)
"d" = (
/turf/simulated/mineral/random/high_chance,
/area/ruin/unpowered)
"e" = (
/turf/simulated/wall/shuttle{
	dir = 4
	},
/area/ruin/unpowered)
"f" = (
/obj/machinery/door/airlock/shuttle,
/turf/simulated/floor/plating/airless,
/area/ruin/unpowered)
"g" = (
/turf/simulated/floor/plating/airless,
/area/ruin/unpowered)
"h" = (
/turf/simulated/floor/mineral/titanium/blue/airless,
/area/ruin/unpowered)
"i" = (
/obj/structure/window/reinforced{
	dir = 8;
	tag = "icon-rwindow (WEST)"
	},
/obj/structure/chair/comfy/shuttle,
/turf/simulated/floor/mineral/titanium/blue/airless,
/area/ruin/unpowered)
"j" = (
/obj/structure/table,
/turf/simulated/floor/mineral/titanium/blue/airless,
/area/ruin/unpowered)
"k" = (
/obj/item/shard,
/obj/structure/chair/comfy/shuttle{
	dir = 8
	},
/turf/simulated/floor/mineral/titanium/blue/airless,
/area/ruin/unpowered)
"l" = (
/obj/structure/shuttle/engine/propulsion{
	dir = 4;
	tag = "icon-propulsion (WEST)"
	},
/turf/simulated/floor/plating/airless,
/area/ruin/unpowered)
"m" = (
/obj/item/shard,
/turf/simulated/floor/plating/airless,
/area/ruin/unpowered)
"n" = (
/obj/structure/chair/comfy/shuttle{
	dir = 8
	},
/turf/simulated/floor/plating/airless,
/area/ruin/unpowered)
"o" = (
/obj/structure/grille,
/turf/simulated/floor/plating/airless,
/area/ruin/unpowered)
"p" = (
/turf/space,
/area/space)
"q" = (
/obj/structure/chair/comfy/shuttle,
/turf/simulated/floor/mineral/titanium/blue/airless,
/area/ruin/unpowered)
"r" = (
/obj/structure/window/reinforced{
	dir = 8;
	tag = "icon-rwindow (WEST)"
	},
/obj/structure/chair/comfy/shuttle{
	dir = 1
	},
/turf/simulated/floor/mineral/titanium/blue/airless,
/area/ruin/unpowered)
"s" = (
/obj/structure/chair/comfy/shuttle{
	dir = 1
	},
/turf/simulated/floor/plating/airless,
/area/ruin/unpowered)
"t" = (
/obj/structure/girder,
/turf/simulated/floor/plating/airless,
/area/ruin/unpowered)
"u" = (
/turf/simulated/wall/shuttle{
	icon_state = "white_walls"
	},
/area/ruin/unpowered)
"A" = (
/turf/simulated/wall/shuttle{
	dir = 1;
	icon_state = "white_walls"
	},
/area/ruin/unpowered)
"D" = (
/obj/effect/spawner/lootdrop/crate_spawner,
/turf/simulated/floor/mineral/titanium/blue/airless,
/area/ruin/unpowered)
"G" = (
/turf/simulated/wall/shuttle{
	dir = 8;
	icon_state = "white_walls_directions"
	},
/area/ruin/unpowered)
"S" = (
/turf/simulated/wall/shuttle{
	dir = 1
	},
/area/ruin/unpowered)
"V" = (
/turf/simulated/wall/shuttle{
	dir = 4;
	icon_state = "white_walls_directions"
	},
/area/ruin/unpowered)

(1,1,1) = {"
a
a
a
a
a
a
a
a
a
a
a
a
a
a
a
a
a
a
a
a
a
a
a
a
a
a
a
a
a
a
a
a
a
a
a
a
a
a
a
a
"}
(2,1,1) = {"
a
a
a
a
a
a
a
a
a
a
a
a
a
a
a
a
a
a
a
a
a
a
a
a
a
a
a
a
a
a
a
a
a
a
a
a
a
a
a
a
"}
(3,1,1) = {"
a
a
p
p
p
p
p
p
p
p
p
p
p
p
p
p
p
p
p
p
p
p
p
p
b
p
p
p
p
p
p
p
p
p
p
p
p
p
a
a
"}
(4,1,1) = {"
a
a
p
p
p
p
p
p
p
p
p
p
p
p
p
p
p
p
p
p
p
p
p
p
p
p
p
b
b
p
p
p
p
p
p
p
p
p
a
a
"}
(5,1,1) = {"
a
a
p
p
p
c
c
p
p
p
p
p
p
p
p
p
p
p
p
p
p
p
p
p
p
p
b
b
b
p
p
p
p
p
p
p
p
p
a
a
"}
(6,1,1) = {"
a
a
p
p
b
c
c
c
p
p
p
p
p
p
p
p
p
p
p
p
p
p
b
p
p
p
b
b
p
p
p
p
p
p
p
p
p
p
a
a
"}
(7,1,1) = {"
a
a
p
b
b
c
c
c
p
p
p
p
p
p
p
p
p
p
p
p
p
p
p
p
p
p
p
p
p
p
p
p
p
p
p
p
p
p
a
a
"}
(8,1,1) = {"
a
a
p
b
b
b
b
b
p
p
p
p
p
p
c
c
p
p
p
p
p
p
p
p
p
p
p
p
p
p
p
p
p
p
p
p
p
p
a
a
"}
(9,1,1) = {"
a
a
p
b
b
b
b
b
p
p
p
p
p
p
c
c
c
c
c
c
c
p
p
p
p
p
p
p
p
p
p
p
p
p
p
p
p
p
a
a
"}
(10,1,1) = {"
a
a
p
p
p
b
b
p
p
p
p
p
p
p
c
c
c
c
c
c
c
b
b
b
p
p
p
p
p
p
p
p
p
p
p
p
p
p
a
a
"}
(11,1,1) = {"
a
a
p
p
p
b
b
p
p
p
p
p
b
c
c
c
c
c
c
c
c
c
b
b
p
p
p
p
p
p
p
p
p
p
p
p
p
p
a
a
"}
(12,1,1) = {"
a
a
p
p
p
p
p
p
p
p
p
p
b
b
b
c
c
c
c
c
c
c
b
b
b
p
p
p
p
p
p
p
p
p
p
p
p
p
a
a
"}
(13,1,1) = {"
a
a
p
p
p
p
p
p
p
p
p
b
b
b
b
b
b
c
c
b
b
b
b
b
b
b
p
p
p
p
p
p
p
p
p
p
p
p
a
a
"}
(14,1,1) = {"
a
a
p
p
p
p
p
p
p
p
p
b
b
b
b
d
d
b
b
b
b
b
b
b
b
d
p
p
p
p
p
p
p
b
b
b
p
p
a
a
"}
(15,1,1) = {"
a
a
p
p
p
p
p
p
p
p
p
d
d
b
b
d
d
b
b
b
d
b
b
b
b
b
p
p
p
p
p
p
p
p
b
b
b
p
a
a
"}
(16,1,1) = {"
a
a
p
p
p
p
p
p
p
p
p
d
d
b
b
b
b
b
b
b
b
b
b
b
b
b
b
p
p
p
p
p
p
b
b
b
b
b
a
a
"}
(17,1,1) = {"
a
a
p
p
p
p
p
p
p
p
p
d
d
d
b
b
b
g
g
o
b
b
c
b
b
d
d
p
p
p
p
p
d
b
b
b
c
c
a
a
"}
(18,1,1) = {"
a
a
p
p
p
p
p
p
p
p
p
d
d
b
b
c
e
g
m
j
g
e
c
b
b
d
d
p
p
p
p
d
d
b
b
d
c
c
a
a
"}
(19,1,1) = {"
a
a
p
p
p
p
p
p
p
p
p
d
b
b
b
c
e
g
n
k
h
e
c
b
b
d
d
p
p
p
d
b
b
b
c
c
c
p
a
a
"}
(20,1,1) = {"
a
a
p
p
p
p
p
p
p
p
p
b
b
b
b
c
e
g
h
h
h
e
c
c
b
b
b
p
p
p
b
b
b
b
c
c
c
p
a
a
"}
(21,1,1) = {"
a
a
p
p
p
p
p
p
p
p
p
b
b
b
c
c
V
h
h
h
h
V
c
c
c
c
b
p
p
d
b
b
c
c
c
c
c
p
a
a
"}
(22,1,1) = {"
a
a
p
p
p
p
p
p
p
p
p
p
b
b
c
c
f
h
h
h
h
f
c
c
c
c
b
p
b
b
b
b
c
c
c
p
p
p
a
a
"}
(23,1,1) = {"
a
a
p
p
p
p
p
p
p
p
p
p
b
b
b
c
G
i
h
h
r
G
c
c
c
c
p
p
b
b
b
c
c
c
p
p
p
p
a
a
"}
(24,1,1) = {"
a
a
p
p
p
p
p
p
p
b
p
p
b
b
b
c
e
q
h
h
s
t
c
c
c
c
p
p
b
b
c
p
p
p
p
p
p
p
a
a
"}
(25,1,1) = {"
a
a
p
p
p
p
p
p
p
p
p
b
b
b
d
c
e
D
h
g
g
g
c
c
p
p
p
p
p
b
c
p
p
p
p
p
p
p
a
a
"}
(26,1,1) = {"
a
a
p
p
p
p
b
b
p
p
p
b
b
b
d
c
u
S
S
S
S
A
c
c
p
p
p
p
p
p
p
p
p
p
p
p
p
p
a
a
"}
(27,1,1) = {"
a
a
p
p
p
b
b
b
p
p
p
b
b
b
d
c
V
l
l
l
l
V
c
c
p
p
p
p
p
p
p
p
p
p
p
p
p
p
a
a
"}
(28,1,1) = {"
a
a
p
p
p
p
b
b
p
p
p
b
b
b
b
b
c
c
c
c
c
c
c
c
p
p
p
p
p
p
p
p
p
p
p
p
p
p
a
a
"}
(29,1,1) = {"
a
a
p
p
p
p
p
p
p
p
p
p
b
b
b
c
c
c
c
c
p
p
p
p
p
p
p
p
p
p
p
p
p
p
p
p
p
p
a
a
"}
(30,1,1) = {"
a
a
p
p
p
p
p
p
p
p
p
p
p
b
b
c
c
c
c
c
p
p
p
p
p
p
p
p
p
p
p
p
p
p
p
p
p
p
a
a
"}
(31,1,1) = {"
a
a
p
p
p
p
p
p
p
p
p
p
p
p
p
p
p
p
p
p
p
p
p
p
p
p
p
p
p
p
p
p
p
p
p
p
p
p
a
a
"}
(32,1,1) = {"
a
a
p
p
p
p
p
p
p
p
p
p
p
p
p
p
p
p
p
p
p
p
p
p
p
p
p
p
p
p
p
p
p
p
p
p
p
p
a
a
"}
(33,1,1) = {"
a
a
p
p
p
p
p
p
p
p
p
p
p
p
p
p
p
p
p
p
p
p
p
p
p
p
p
p
p
c
c
c
p
p
p
p
p
p
a
a
"}
(34,1,1) = {"
a
a
p
p
p
p
p
p
p
p
p
p
p
p
p
p
p
p
p
p
p
p
p
p
p
p
p
p
c
c
b
b
p
p
p
p
p
p
a
a
"}
(35,1,1) = {"
a
a
p
p
p
p
p
p
p
p
p
p
p
p
p
p
p
p
p
p
p
p
p
p
p
p
p
p
c
c
d
b
p
p
p
p
p
p
a
a
"}
(36,1,1) = {"
a
a
p
p
p
p
p
p
p
p
p
p
p
p
p
p
p
p
p
p
p
p
p
p
p
p
b
p
b
d
b
b
p
p
p
p
p
p
a
a
"}
(37,1,1) = {"
a
a
p
p
p
p
p
p
p
p
p
p
p
p
p
p
p
p
p
p
p
p
p
p
p
p
p
p
b
b
p
p
p
p
p
p
p
p
a
a
"}
(38,1,1) = {"
a
a
p
p
p
p
p
p
p
p
p
p
p
p
p
p
p
p
p
p
p
p
p
p
p
p
p
p
p
p
p
p
p
p
p
p
p
p
a
a
"}
(39,1,1) = {"
a
a
a
a
a
a
a
a
a
a
a
a
a
a
a
a
a
a
a
a
a
a
a
a
a
a
a
a
a
a
a
a
a
a
a
a
a
a
a
a
"}
(40,1,1) = {"
a
a
a
a
a
a
a
a
a
a
a
a
a
a
a
a
a
a
a
a
a
a
a
a
a
a
a
a
a
a
a
a
a
a
a
a
a
a
a
a
"}
