//MAP CONVERTED BY dmm2tgm.py THIS HEADER COMMENT PREVENTS RECONVERSION, DO NOT REMOVE
"ab" = (
/obj/structure/cable{
	d1 = 1;
	d2 = 8;
	icon_state = "1-8";
	tag = ""
	},
/turf/simulated/floor/mineral/titanium/airless,
/area/ruin/space/ipcship/engine)
"aw" = (
/obj/structure/cable{
	d1 = 4;
	d2 = 8;
	icon_state = "4-8";
	tag = ""
	},
/obj/structure/cable{
	icon_state = "1-4"
	},
/obj/structure/cable{
	icon_state = "2-4"
	},
/turf/simulated/floor/mineral/titanium/airless,
/area/ruin/space/ipcship/bridge)
"aL" = (
/obj/structure/table,
/obj/machinery/cell_charger{
	pixel_x = -1;
	pixel_y = 2
	},
/obj/item/stock_parts/cell/crap,
/turf/simulated/floor/mineral/titanium/airless,
/area/ruin/space/ipcship/bridge)
"aV" = (
/obj/machinery/atmospherics/unary/portables_connector{
	dir = 1
	},
/turf/simulated/floor/mineral/titanium/airless,
/area/ruin/space/ipcship/engine)
"bM" = (
/obj/structure/window/full/shuttle/gray,
/turf/simulated/floor/mineral/titanium/airless,
/area/ruin/space/ipcship/fabricator)
"bQ" = (
/obj/structure/cable{
	d1 = 4;
	d2 = 8;
	icon_state = "4-8";
	tag = ""
	},
/turf/simulated/floor/mineral/titanium/airless,
/area/ruin/space/ipcship/engine)
"cc" = (
/obj/structure/cable{
	d1 = 1;
	d2 = 4;
	icon_state = "1-4"
	},
/turf/simulated/floor/mineral/titanium/airless,
/area/ruin/space/ipcship/engine)
"ci" = (
/obj/structure/cable{
	d1 = 2;
	d2 = 4;
	icon_state = "2-4"
	},
/turf/simulated/floor/mineral/titanium/airless,
/area/ruin/space/ipcship/fabricator)
"cq" = (
/obj/item/mounted/frame/apc_frame,
/turf/simulated/floor/mineral/titanium/airless,
/area/ruin/space/ipcship/bridge)
"cG" = (
/obj/structure/cable{
	d1 = 4;
	d2 = 8;
	icon_state = "4-8";
	tag = ""
	},
/turf/simulated/floor/mineral/titanium/airless,
/area/ruin/space/ipcship/bridge)
"eh" = (
/obj/machinery/atmospherics/pipe/simple/visible{
	dir = 6;
	level = 1
	},
/obj/machinery/portable_atmospherics/canister/nitrogen,
/turf/simulated/floor/mineral/titanium/airless,
/area/ruin/space/ipcship/engine)
"eY" = (
/obj/structure/cable{
	icon_state = "2-8"
	},
/obj/machinery/alarm{
	dir = 8;
	pixel_x = 24
	},
/turf/simulated/floor/mineral/titanium/airless,
/area/ruin/space/ipcship/engine)
"gz" = (
/obj/structure/cable{
	d1 = 2;
	d2 = 4;
	icon_state = "2-4"
	},
/turf/simulated/floor/mineral/titanium/airless,
/area/ruin/space/ipcship/engine)
"he" = (
/turf/space,
/area/ruin/space/ipcship/engine)
"hZ" = (
/obj/machinery/mecha_part_fabricator,
/obj/effect/decal/warning_stripes/yellow/hollow,
/obj/effect/decal/warning_stripes/north,
/turf/simulated/floor/plasteel{
	dir = 8;
	icon_state = "neutralfull"
	},
/area/ruin/space/ipcship/fabricator)
"ij" = (
/obj/structure/cable{
	icon_state = "1-4"
	},
/turf/simulated/floor/mineral/titanium/airless,
/area/ruin/space/ipcship/operating)
"iP" = (
/turf/simulated/floor/mineral/titanium/airless,
/area/ruin/space/ipcship/bridge)
"jW" = (
/obj/machinery/door/airlock/hatch,
/obj/structure/cable{
	d1 = 1;
	d2 = 2;
	icon_state = "1-2"
	},
/turf/simulated/floor/mineral/titanium/airless,
/area/ruin/space/ipcship/engine)
"kP" = (
/obj/structure/shuttle/engine/large{
	dir = 4
	},
/turf/space,
/area/ruin/space/ipcship/engine)
"mc" = (
/obj/machinery/atmospherics/pipe/manifold/visible{
	dir = 1
	},
/turf/simulated/floor/mineral/titanium/airless,
/area/ruin/space/ipcship/engine)
"mj" = (
/obj/machinery/power/grounding_rod{
	anchored = 1
	},
/turf/simulated/floor/mineral/titanium/airless,
/area/ruin/space/ipcship/engine)
"mF" = (
/obj/machinery/atmospherics/unary/vent_scrubber,
/turf/simulated/floor/engine,
/area/ruin/space/ipcship/engine)
"nv" = (
/obj/structure/window/full/shuttle/gray,
/turf/simulated/floor/mineral/titanium/airless,
/area/ruin/space/ipcship/bridge)
"ny" = (
/obj/machinery/atmospherics/pipe/simple/visible,
/turf/simulated/floor/mineral/titanium/airless,
/area/ruin/space/ipcship/engine)
"nS" = (
/obj/machinery/door/airlock/hatch,
/obj/structure/cable{
	d1 = 1;
	d2 = 2;
	icon_state = "1-2"
	},
/turf/simulated/floor/mineral/titanium/airless,
/area/ruin/space/ipcship/fabricator)
"pD" = (
/obj/machinery/power/supermatter_shard{
	anchored = 1
	},
/turf/simulated/floor/engine,
/area/ruin/space/ipcship/engine)
"sH" = (
/obj/machinery/atmospherics/pipe/simple/visible{
	dir = 10
	},
/obj/structure/cable{
	icon_state = "1-8"
	},
/turf/simulated/floor/mineral/titanium/airless,
/area/ruin/space/ipcship/engine)
"ti" = (
/obj/machinery/door/airlock/hatch,
/obj/structure/cable{
	d1 = 1;
	d2 = 2;
	icon_state = "1-2";
	tag = ""
	},
/turf/simulated/floor/mineral/titanium/airless,
/area/ruin/space/ipcship/engine)
"tw" = (
/obj/machinery/atmospherics/pipe/simple/visible{
	dir = 5
	},
/obj/structure/cable{
	d1 = 1;
	d2 = 2;
	icon_state = "1-2"
	},
/turf/simulated/floor/mineral/titanium/airless,
/area/ruin/space/ipcship/engine)
"tH" = (
/obj/structure/cable{
	icon_state = "1-2"
	},
/turf/simulated/floor/mineral/titanium/airless,
/area/ruin/space/ipcship/engine)
"uw" = (
/obj/structure/closet/crate/trashcart,
/turf/simulated/floor/mineral/titanium/airless,
/area/ruin/space/ipcship/operating)
"uP" = (
/turf/space,
/area/space)
"vl" = (
/turf/simulated/floor/mineral/titanium/airless,
/area/ruin/space/ipcship/operating)
"vB" = (
/obj/machinery/power/smes,
/turf/simulated/floor/mineral/titanium/airless,
/area/ruin/space/ipcship/engine)
"vL" = (
/obj/structure/chair/comfy/shuttle{
	dir = 1
	},
/turf/simulated/floor/mineral/titanium/airless,
/area/ruin/space/ipcship/bridge)
"wi" = (
/obj/machinery/atmospherics/binary/volume_pump/on{
	dir = 8
	},
/obj/structure/cable{
	d1 = 1;
	d2 = 4;
	icon_state = "1-4";
	tag = ""
	},
/turf/simulated/floor/mineral/titanium/airless,
/area/ruin/space/ipcship/engine)
"wu" = (
/obj/structure/closet,
/obj/item/stack/sheet/metal{
	amount = 50
	},
/obj/item/stack/sheet/metal{
	amount = 50
	},
/obj/item/stack/sheet/metal{
	amount = 50
	},
/obj/item/stack/sheet/metal{
	amount = 50
	},
/obj/item/stack/sheet/glass{
	amount = 50
	},
/obj/item/stack/sheet/glass{
	amount = 50
	},
/obj/item/stack/sheet/plasteel{
	amount = 15
	},
/obj/item/stack/sheet/plasteel{
	amount = 10
	},
/obj/effect/decal/warning_stripes/yellow/hollow,
/obj/effect/decal/warning_stripes/north,
/turf/simulated/floor/plasteel{
	dir = 8;
	icon_state = "neutralfull"
	},
/area/ruin/space/ipcship/fabricator)
"xn" = (
/obj/item/gps/ruin{
	pixel_x = -33
	},
/obj/structure/table,
/turf/simulated/floor/mineral/titanium/airless,
/area/ruin/space/ipcship/bridge)
"xE" = (
/obj/machinery/optable,
/turf/simulated/floor/mineral/titanium/airless,
/area/ruin/space/ipcship/operating)
"yi" = (
/obj/structure/cable,
/turf/simulated/floor/mineral/titanium/airless,
/area/ruin/space/ipcship/bridge)
"yy" = (
/obj/machinery/computer/sm_monitor,
/obj/structure/cable{
	d1 = 4;
	d2 = 8;
	icon_state = "4-8";
	tag = ""
	},
/turf/simulated/floor/mineral/titanium/airless,
/area/ruin/space/ipcship/engine)
"yz" = (
/obj/structure/cable{
	d2 = 8;
	icon_state = "0-8"
	},
/obj/machinery/power/apc/noalarm{
	locked = 0;
	pixel_y = -24;
	equipment = 0;
	environ = 0;
	operating = 0
	},
/turf/simulated/floor/mineral/titanium/airless,
/area/ruin/space/ipcship/fabricator)
"ze" = (
/turf/simulated/floor/mineral/titanium/airless,
/area/ruin/space/ipcship/fabricator)
"zB" = (
/obj/machinery/computer,
/turf/simulated/floor/mineral/titanium/airless,
/area/ruin/space/ipcship/fabricator)
"zH" = (
/obj/machinery/atmospherics/pipe/simple/visible,
/obj/structure/cable{
	d1 = 4;
	d2 = 8;
	icon_state = "4-8";
	tag = ""
	},
/obj/structure/cable{
	d1 = 2;
	d2 = 8;
	icon_state = "2-8"
	},
/turf/simulated/floor/mineral/titanium/airless,
/area/ruin/space/ipcship/engine)
"Ad" = (
/obj/structure/window/full/shuttle/gray,
/turf/simulated/floor/mineral/titanium/airless,
/area/ruin/space/ipcship/operating)
"Ah" = (
/obj/machinery/power/rad_collector,
/obj/machinery/atmospherics/pipe/simple/visible,
/turf/simulated/floor/mineral/titanium/airless,
/area/ruin/space/ipcship/engine)
"Am" = (
/obj/machinery/power/rad_collector,
/obj/machinery/atmospherics/pipe/simple/visible{
	dir = 1
	},
/turf/simulated/floor/mineral/titanium/airless,
/area/ruin/space/ipcship/engine)
"Bj" = (
/obj/structure/grille,
/obj/structure/window/plasmareinforced,
/obj/structure/window/plasmareinforced{
	dir = 4
	},
/obj/structure/window/plasmareinforced{
	dir = 1
	},
/obj/structure/window/plasmareinforced{
	dir = 8
	},
/turf/simulated/floor/plating,
/area/ruin/space/ipcship/engine)
"Cg" = (
/obj/structure/cable{
	d1 = 1;
	d2 = 4;
	icon_state = "1-4";
	tag = ""
	},
/turf/simulated/floor/mineral/titanium/airless,
/area/ruin/space/ipcship/engine)
"Cr" = (
/obj/structure/cable{
	d1 = 4;
	d2 = 8;
	icon_state = "4-8";
	tag = ""
	},
/obj/machinery/door/airlock/highsecurity,
/turf/simulated/floor/mineral/titanium/airless,
/area/ruin/space/ipcship/engine)
"Cu" = (
/turf/simulated/floor/mineral/titanium/airless,
/area/ruin/space/ipcship/engine)
"DF" = (
/obj/item/apc_electronics,
/turf/simulated/floor/mineral/titanium/airless,
/area/ruin/space/ipcship/bridge)
"Fw" = (
/obj/structure/table,
/obj/item/clothing/glasses/meson,
/turf/simulated/floor/mineral/titanium/airless,
/area/ruin/space/ipcship/engine)
"FC" = (
/obj/structure/cable{
	d1 = 2;
	d2 = 4;
	icon_state = "2-4";
	tag = ""
	},
/turf/simulated/floor/mineral/titanium/airless,
/area/ruin/space/ipcship/engine)
"Gm" = (
/obj/machinery/door/airlock/hatch,
/obj/structure/cable{
	d1 = 4;
	d2 = 8;
	icon_state = "4-8";
	tag = ""
	},
/turf/simulated/floor/mineral/titanium/airless,
/area/ruin/space/ipcship/bridge)
"Hv" = (
/obj/structure/chair/comfy/shuttle{
	dir = 8
	},
/turf/simulated/floor/mineral/titanium/airless,
/area/ruin/space/ipcship/bridge)
"HM" = (
/obj/machinery/door/airlock/hatch,
/obj/structure/cable{
	d1 = 1;
	d2 = 2;
	icon_state = "1-2"
	},
/turf/simulated/floor/mineral/titanium/airless,
/area/ruin/space/ipcship/operating)
"IU" = (
/obj/machinery/atmospherics/pipe/simple/visible{
	dir = 4
	},
/obj/structure/table,
/obj/item/wrench,
/turf/simulated/floor/mineral/titanium/airless,
/area/ruin/space/ipcship/engine)
"JY" = (
/obj/item/storage/bag/trash,
/turf/simulated/floor/mineral/titanium/airless,
/area/ruin/space/ipcship/operating)
"Km" = (
/obj/structure/cable{
	d2 = 8;
	icon_state = "0-8"
	},
/obj/machinery/power/apc/noalarm{
	locked = 0;
	pixel_y = 24;
	equipment = 0;
	environ = 0;
	operating = 0;
	dir = 1
	},
/turf/simulated/floor/mineral/titanium/airless,
/area/ruin/space/ipcship/operating)
"KS" = (
/obj/machinery/atmospherics/pipe/manifold/visible{
	dir = 1
	},
/obj/structure/table,
/obj/item/tank/internals/plasma/full,
/turf/simulated/floor/mineral/titanium/airless,
/area/ruin/space/ipcship/engine)
"KZ" = (
/obj/machinery/atmospherics/unary/cold_sink/freezer{
	dir = 1
	},
/turf/simulated/floor/mineral/titanium/airless,
/area/ruin/space/ipcship/engine)
"La" = (
/turf/simulated/wall/r_wall/coated,
/area/ruin/space/ipcship/engine)
"Le" = (
/obj/structure/table,
/obj/item/t_scanner,
/turf/simulated/floor/mineral/titanium/airless,
/area/ruin/space/ipcship/engine)
"Lt" = (
/obj/item/storage/belt/utility,
/obj/item/clothing/glasses/welding,
/obj/item/clothing/glasses/hud/diagnostic{
	pixel_x = 2;
	pixel_y = 5
	},
/obj/structure/closet/walllocker{
	pixel_x = 32
	},
/obj/item/storage/toolbox/mechanical{
	pixel_x = -2;
	pixel_y = -1
	},
/turf/simulated/floor/mineral/titanium/airless,
/area/ruin/space/ipcship/operating)
"Mr" = (
/obj/effect/spawner/window/reinforced/plasma,
/obj/machinery/atmospherics/pipe/simple/visible,
/turf/simulated/floor/mineral/titanium/airless,
/area/ruin/space/ipcship/engine)
"Mz" = (
/obj/machinery/power/terminal{
	dir = 1
	},
/obj/structure/cable{
	d2 = 8;
	icon_state = "0-8"
	},
/turf/simulated/floor/mineral/titanium/airless,
/area/ruin/space/ipcship/engine)
"MF" = (
/obj/machinery/power/emitter{
	dir = 4
	},
/obj/structure/cable{
	d1 = 1;
	d2 = 2;
	icon_state = "1-2"
	},
/obj/structure/cable{
	d1 = 2;
	d2 = 8;
	icon_state = "2-8"
	},
/obj/structure/cable{
	d1 = 1;
	d2 = 8;
	icon_state = "1-8"
	},
/obj/structure/cable{
	d2 = 8;
	icon_state = "0-8"
	},
/turf/simulated/floor/mineral/titanium/airless,
/area/ruin/space/ipcship/engine)
"MS" = (
/obj/machinery/atmospherics/unary/vent_pump/on{
	dir = 1
	},
/turf/simulated/floor/engine,
/area/ruin/space/ipcship/engine)
"NG" = (
/obj/structure/cable{
	d1 = 1;
	d2 = 2;
	icon_state = "1-2"
	},
/turf/simulated/floor/mineral/titanium/airless,
/area/ruin/space/ipcship/engine)
"NN" = (
/obj/structure/chair/comfy/shuttle,
/turf/simulated/floor/mineral/titanium/airless,
/area/ruin/space/ipcship/bridge)
"Ov" = (
/obj/machinery/atmospherics/pipe/simple/visible{
	dir = 5
	},
/turf/simulated/floor/mineral/titanium/airless,
/area/ruin/space/ipcship/engine)
"Qd" = (
/obj/machinery/atmospherics/pipe/simple/visible{
	dir = 4
	},
/obj/machinery/portable_atmospherics/canister/nitrogen,
/turf/simulated/floor/mineral/titanium/airless,
/area/ruin/space/ipcship/engine)
"Qn" = (
/obj/machinery/atmospherics/pipe/simple/visible,
/obj/structure/cable{
	d1 = 1;
	d2 = 2;
	icon_state = "1-2"
	},
/turf/simulated/floor/mineral/titanium/airless,
/area/ruin/space/ipcship/engine)
"Rb" = (
/obj/machinery/power/terminal,
/obj/structure/cable{
	d2 = 8;
	icon_state = "0-8"
	},
/turf/simulated/floor/mineral/titanium/airless,
/area/ruin/space/ipcship/engine)
"Rm" = (
/obj/machinery/atmospherics/binary/volume_pump/on{
	dir = 4
	},
/obj/structure/cable{
	icon_state = "2-4"
	},
/turf/simulated/floor/mineral/titanium/airless,
/area/ruin/space/ipcship/engine)
"RW" = (
/obj/machinery/atmospherics/pipe/simple/visible{
	dir = 10
	},
/turf/simulated/floor/mineral/titanium/airless,
/area/ruin/space/ipcship/engine)
"RZ" = (
/obj/structure/cable,
/obj/machinery/power/apc/noalarm{
	locked = 0;
	pixel_y = -24
	},
/turf/simulated/floor/mineral/titanium/airless,
/area/ruin/space/ipcship/engine)
"Sh" = (
/obj/structure/chair/office/light{
	dir = 4
	},
/obj/structure/cable{
	d1 = 4;
	d2 = 8;
	icon_state = "4-8";
	tag = ""
	},
/turf/simulated/floor/mineral/titanium/airless,
/area/ruin/space/ipcship/engine)
"SJ" = (
/obj/structure/cable{
	icon_state = "2-4"
	},
/turf/simulated/floor/mineral/titanium/airless,
/area/ruin/space/ipcship/bridge)
"SN" = (
/obj/machinery/computer/operating{
	name = "Robotics Operating Computer"
	},
/turf/simulated/floor/mineral/titanium/airless,
/area/ruin/space/ipcship/operating)
"Tw" = (
/turf/simulated/wall/shuttle{
	icon = 'icons/turf/walls/shuttle/gray_shuttle_wall.dmi'
	},
/area/ruin/space/ipcship/bridge)
"TQ" = (
/obj/machinery/atmospherics/pipe/simple/visible{
	dir = 9
	},
/obj/structure/cable{
	d1 = 2;
	d2 = 8;
	icon_state = "2-8";
	tag = ""
	},
/turf/simulated/floor/mineral/titanium/airless,
/area/ruin/space/ipcship/engine)
"UR" = (
/obj/machinery/mecha_part_fabricator,
/obj/effect/decal/warning_stripes/yellow/hollow,
/obj/effect/decal/warning_stripes/northwest,
/turf/simulated/floor/plasteel{
	dir = 8;
	icon_state = "neutralfull"
	},
/area/ruin/space/ipcship/fabricator)
"UU" = (
/obj/structure/table,
/turf/simulated/floor/mineral/titanium/airless,
/area/ruin/space/ipcship/bridge)
"UV" = (
/turf/simulated/wall/shuttle{
	icon = 'icons/turf/walls/shuttle/gray_shuttle_wall.dmi'
	},
/area/ruin/space/ipcship/operating)
"Vs" = (
/obj/machinery/atmospherics/binary/valve/digital{
	dir = 4
	},
/obj/structure/cable{
	d1 = 4;
	d2 = 8;
	icon_state = "4-8";
	tag = ""
	},
/turf/simulated/floor/mineral/titanium/airless,
/area/ruin/space/ipcship/engine)
"WE" = (
/obj/machinery/atmospherics/pipe/simple/visible{
	dir = 4
	},
/obj/structure/table,
/obj/item/tank/internals/plasma/full,
/turf/simulated/floor/mineral/titanium/airless,
/area/ruin/space/ipcship/engine)
"WH" = (
/turf/simulated/wall/shuttle{
	icon = 'icons/turf/walls/shuttle/gray_shuttle_wall.dmi'
	},
/area/ruin/space/ipcship/engine)
"XN" = (
/obj/structure/table,
/obj/machinery/cell_charger{
	pixel_y = 2
	},
/obj/item/stock_parts/cell/crap,
/turf/simulated/floor/mineral/titanium/airless,
/area/ruin/space/ipcship/bridge)
"Yl" = (
/turf/simulated/wall/shuttle{
	icon = 'icons/turf/walls/shuttle/gray_shuttle_wall.dmi'
	},
/area/ruin/space/ipcship/fabricator)
"YP" = (
/obj/machinery/computer,
/turf/simulated/floor/mineral/titanium/airless,
/area/ruin/space/ipcship/bridge)
"Za" = (
/obj/item/storage/belt/utility,
/obj/item/clothing/glasses/welding,
/obj/item/clothing/glasses/hud/diagnostic{
	pixel_x = 2;
	pixel_y = 5
	},
/obj/structure/closet/walllocker{
	pixel_x = -32
	},
/obj/item/storage/toolbox/mechanical{
	pixel_x = -2;
	pixel_y = -1
	},
/turf/simulated/floor/mineral/titanium/airless,
/area/ruin/space/ipcship/operating)
"Zf" = (
/obj/structure/table/tray,
/obj/item/storage/firstaid/machine,
/obj/item/robotanalyzer,
/turf/simulated/floor/mineral/titanium/airless,
/area/ruin/space/ipcship/operating)
"ZU" = (
/obj/structure/window/full/shuttle/gray,
/turf/simulated/floor/mineral/titanium/airless,
/area/ruin/space/ipcship/engine)

(1,1,1) = {"
uP
uP
uP
uP
uP
uP
uP
uP
uP
uP
uP
uP
uP
uP
uP
uP
uP
uP
uP
uP
uP
uP
uP
uP
uP
uP
uP
uP
uP
uP
"}
(2,1,1) = {"
uP
uP
uP
uP
uP
uP
uP
uP
uP
uP
uP
uP
uP
uP
uP
uP
uP
uP
uP
uP
uP
uP
uP
uP
uP
uP
uP
uP
uP
uP
"}
(3,1,1) = {"
uP
uP
uP
uP
uP
uP
uP
uP
uP
uP
uP
uP
uP
uP
uP
uP
uP
uP
uP
uP
uP
uP
uP
uP
uP
uP
uP
uP
uP
uP
"}
(4,1,1) = {"
uP
uP
uP
uP
uP
uP
uP
uP
uP
uP
uP
uP
uP
uP
uP
uP
uP
uP
uP
uP
uP
uP
uP
uP
uP
uP
uP
uP
uP
uP
"}
(5,1,1) = {"
uP
uP
uP
uP
uP
uP
uP
uP
uP
uP
uP
uP
uP
Tw
Tw
nv
nv
Tw
nv
nv
Tw
Tw
uP
uP
uP
uP
uP
uP
uP
uP
"}
(6,1,1) = {"
uP
uP
uP
uP
uP
uP
uP
uP
uP
uP
uP
uP
Tw
Tw
XN
YP
YP
xn
YP
YP
aL
Tw
Tw
uP
uP
uP
uP
uP
uP
uP
"}
(7,1,1) = {"
uP
uP
uP
uP
uP
uP
uP
uP
uP
uP
uP
uP
Tw
UU
iP
Hv
Hv
iP
Hv
Hv
iP
UU
Tw
uP
uP
uP
uP
uP
uP
uP
"}
(8,1,1) = {"
uP
uP
uP
uP
uP
uP
uP
uP
uP
uP
uP
uP
nv
vL
iP
iP
iP
iP
iP
iP
iP
NN
nv
uP
uP
uP
uP
uP
uP
uP
"}
(9,1,1) = {"
uP
uP
uP
uP
uP
uP
uP
uP
uP
uP
uP
uP
nv
vL
iP
cq
iP
iP
iP
iP
iP
NN
nv
uP
uP
uP
uP
uP
uP
uP
"}
(10,1,1) = {"
uP
uP
uP
uP
uP
uP
uP
uP
uP
uP
uP
uP
Tw
UU
DF
iP
iP
SJ
yi
iP
iP
UU
Tw
uP
uP
uP
uP
uP
uP
uP
"}
(11,1,1) = {"
uP
uP
uP
uP
uP
uP
uP
uP
uP
uP
uP
uP
Tw
Tw
Tw
Tw
Tw
Gm
Tw
Tw
Tw
Tw
Tw
uP
uP
uP
uP
uP
uP
uP
"}
(12,1,1) = {"
uP
uP
uP
uP
uP
uP
uP
uP
uP
uP
uP
uP
Yl
zB
ze
ze
Yl
cG
UV
Za
Zf
SN
UV
uP
uP
uP
uP
uP
uP
uP
"}
(13,1,1) = {"
uP
uP
uP
uP
uP
uP
uP
uP
uP
uP
uP
uP
bM
UR
ze
ze
Yl
cG
UV
JY
vl
xE
Ad
uP
uP
uP
uP
uP
uP
uP
"}
(14,1,1) = {"
uP
uP
uP
uP
uP
uP
uP
uP
uP
uP
uP
uP
bM
wu
ze
ci
nS
aw
HM
ij
vl
uw
Ad
uP
uP
uP
uP
uP
uP
uP
"}
(15,1,1) = {"
uP
uP
uP
uP
uP
uP
uP
uP
uP
uP
uP
uP
bM
hZ
ze
yz
Yl
cG
UV
Km
vl
xE
Ad
uP
uP
uP
uP
uP
uP
uP
"}
(16,1,1) = {"
uP
uP
uP
uP
uP
uP
uP
uP
uP
uP
uP
uP
Yl
zB
ze
ze
Yl
cG
UV
Lt
Zf
SN
UV
uP
uP
uP
uP
uP
uP
uP
"}
(17,1,1) = {"
uP
uP
uP
uP
uP
uP
uP
uP
uP
uP
uP
uP
WH
WH
WH
WH
WH
Cr
WH
WH
WH
WH
WH
uP
uP
uP
uP
uP
uP
uP
"}
(18,1,1) = {"
uP
uP
uP
uP
uP
uP
uP
uP
uP
uP
uP
uP
WH
eh
ny
ny
ny
zH
Qn
Qn
tw
RZ
WH
uP
uP
uP
uP
uP
uP
uP
"}
(19,1,1) = {"
uP
uP
uP
uP
uP
uP
uP
uP
uP
uP
uP
uP
ZU
WE
Cu
Cu
Cu
bQ
Cu
Cu
mc
KZ
ZU
uP
uP
uP
uP
uP
uP
uP
"}
(20,1,1) = {"
uP
uP
uP
uP
uP
uP
uP
uP
uP
uP
uP
uP
ZU
KS
aV
Cu
Cu
Sh
Cu
Cu
mc
KZ
ZU
uP
uP
uP
uP
uP
uP
uP
"}
(21,1,1) = {"
uP
uP
uP
uP
uP
uP
uP
uP
uP
uP
uP
uP
ZU
IU
Cu
Cu
Le
yy
Fw
Cu
mc
KZ
ZU
uP
uP
uP
uP
uP
uP
uP
"}
(22,1,1) = {"
uP
uP
uP
uP
uP
uP
uP
uP
uP
uP
WH
WH
WH
Qd
Cu
gz
NG
MF
NG
cc
RW
Ov
WH
WH
WH
uP
uP
uP
uP
uP
"}
(23,1,1) = {"
uP
uP
uP
uP
uP
uP
uP
uP
uP
WH
WH
WH
WH
Rm
NG
ab
mj
Cu
mj
eY
tH
wi
WH
WH
WH
WH
uP
uP
uP
uP
"}
(24,1,1) = {"
uP
uP
uP
uP
uP
uP
uP
uP
WH
WH
Cu
Cu
WH
Vs
mj
La
La
Bj
La
La
mj
Vs
WH
Cu
Cu
WH
WH
uP
uP
uP
"}
(25,1,1) = {"
uP
uP
uP
uP
uP
uP
uP
uP
WH
Cu
Cu
FC
ti
sH
Ah
Mr
MS
pD
mF
Mr
Am
TQ
jW
NG
Cg
Cu
WH
uP
uP
uP
"}
(26,1,1) = {"
uP
uP
uP
uP
uP
uP
uP
uP
WH
Cu
FC
ab
WH
Cu
mj
La
La
La
La
La
mj
Cu
WH
Cu
bQ
Cu
WH
uP
uP
uP
"}
(27,1,1) = {"
uP
uP
uP
uP
uP
uP
uP
uP
WH
Cu
Rb
vB
WH
WH
WH
WH
WH
WH
WH
WH
WH
WH
WH
vB
Mz
Cu
WH
uP
uP
uP
"}
(28,1,1) = {"
uP
uP
uP
uP
uP
uP
uP
uP
WH
WH
WH
WH
WH
he
kP
he
kP
WH
he
kP
he
kP
WH
WH
WH
WH
WH
uP
uP
uP
"}
(29,1,1) = {"
uP
uP
uP
uP
uP
uP
uP
uP
uP
uP
uP
uP
WH
he
he
he
he
WH
he
he
he
he
WH
uP
uP
uP
uP
uP
uP
uP
"}
(30,1,1) = {"
uP
uP
uP
uP
uP
uP
uP
uP
uP
uP
uP
uP
uP
uP
uP
uP
uP
uP
uP
uP
uP
uP
uP
uP
uP
uP
uP
uP
uP
uP
"}
