//MAP CONVERTED BY dmm2tgm.py THIS HEADER COMMENT PREVENTS RECONVERSION, DO NOT REMOVE
"dJ" = (
/obj/item/clothing/suit/hooded/cultrobes/cult_shield,
/obj/effect/decal/cleanable/blood/old,
/turf/simulated/floor/engine/cult,
/area/ruin/unpowered)
"ge" = (
/obj/structure/table/wood,
/obj/item/spellbook/oneuse/fake_gib,
/turf/simulated/floor/engine/cult,
/area/ruin/unpowered)
"iG" = (
/obj/structure/cult/archives,
/turf/simulated/floor/engine/cult,
/area/ruin/unpowered)
"jV" = (
/obj/machinery/door/airlock/public,
/turf/simulated/floor/engine/cult,
/area/ruin/unpowered)
"kg" = (
/obj/effect/decal/remains/human,
/obj/effect/decal/cleanable/blood/old,
/turf/simulated/floor/engine/cult,
/area/ruin/unpowered)
"lw" = (
/obj/effect/decal/cleanable/blood/old,
/turf/simulated/mineral/random,
/area/ruin/unpowered)
"nl" = (
/obj/machinery/portable_atmospherics/canister/oxygen,
/turf/simulated/floor/engine/cult,
/area/ruin/unpowered)
"oc" = (
/turf/simulated/mineral/random,
/area/ruin/unpowered)
"oo" = (
/obj/item/clothing/shoes/cult,
/turf/simulated/floor/engine/cult,
/area/ruin/unpowered)
"pf" = (
/obj/item/flag/cult,
/turf/simulated/floor/engine/cult,
/area/ruin/unpowered)
"pj" = (
/obj/structure/table/wood,
/obj/item/storage/firstaid/doctor,
/turf/simulated/floor/engine/cult,
/area/ruin/unpowered)
"qE" = (
/obj/structure/table/wood,
/obj/item/candle/eternal,
/obj/item/whetstone/cult,
/turf/simulated/floor/engine/cult,
/area/ruin/unpowered)
"sW" = (
/turf/simulated/wall/shuttle,
/area/ruin/unpowered)
"vK" = (
/obj/structure/shuttle/engine/heater{
	dir = 1;
	tag = "icon-heater (NORTH)"
	},
/obj/structure/window/plasmareinforced,
/turf/simulated/floor/plating,
/area/ruin/unpowered)
"vW" = (
/obj/item/reagent_containers/food/drinks/bottle/unholywater,
/turf/simulated/floor/engine/cult,
/area/ruin/unpowered)
"xv" = (
/turf/space,
/area/space)
"xZ" = (
/turf/simulated/wall/cult,
/area/ruin/unpowered)
"yu" = (
/turf/simulated/wall/indestructible/necropolis,
/area/ruin/unpowered)
"AW" = (
/obj/structure/table/wood/fancy/black,
/obj/item/storage/toolbox/emergency,
/turf/simulated/floor/engine/cult,
/area/ruin/unpowered)
"Bg" = (
/mob/living/simple_animal/hostile/illusion/cult{
	deathmessage = "disappears into the air with a cry of agony";
	desc = "The deceived soul";
	health = 200;
	maxHealth = 350;
	name = "The soul of the cultist";
	icon = 'icons/mob/mob.dmi';
	icon_living = "shade";
	icon_state = "shade";
	icon_dead = "shade_dead";
	melee_damage_lower = 10;
	melee_damage_upper = 25
	},
/turf/simulated/floor/engine/cult,
/area/ruin/unpowered)
"Bs" = (
/obj/effect/rune/narsie{
	color = "#ff0000";
	used = 1
	},
/obj/item/clothing/accessory/medal/fluff/elo{
	name = "Bloody Medal";
	desc = "Rusted and bloodstained medal. Given to who believes in... illegible to you, rust erased last words."
	},
/mob/living/simple_animal/hostile/illusion/cult{
	deathmessage = "disappears into the air with a cry of agony";
	desc = "The deceived soul";
	health = 350;
	maxHealth = 350;
	name = "The soul of the cultist";
	icon = 'icons/mob/mob.dmi';
	icon_living = "shade";
	icon_state = "shade";
	icon_dead = "shade_dead";
	melee_damage_lower = 10;
	melee_damage_upper = 25
	},
/turf/simulated/floor/engine/cult,
/area/ruin/unpowered)
"Cb" = (
/obj/structure/window/full/shuttle,
/obj/structure/grille,
/turf/simulated/floor/plating,
/area/ruin/unpowered)
"Cj" = (
/mob/living/simple_animal/hostile/illusion/cult{
	deathmessage = "disappears into the air with a cry of agony";
	desc = "The deceived soul";
	health = 350;
	maxHealth = 350;
	name = "The soul of the cultist";
	icon = 'icons/mob/mob.dmi';
	icon_living = "shade";
	icon_state = "shade";
	icon_dead = "shade_dead";
	melee_damage_lower = 10;
	melee_damage_upper = 25
	},
/turf/simulated/floor/engine/cult,
/area/ruin/unpowered)
"CJ" = (
/turf/simulated/wall/shuttle/nosmooth,
/area/ruin/unpowered)
"CO" = (
/obj/item/melee/cultblade,
/turf/simulated/floor/engine/cult,
/area/ruin/unpowered)
"CT" = (
/obj/effect/decal/cleanable/blood/old,
/mob/living/simple_animal/hostile/illusion/cult{
	deathmessage = "disappears into the air with a cry of agony";
	desc = "The deceived soul";
	health = 200;
	maxHealth = 350;
	name = "The soul of the cultist";
	icon = 'icons/mob/mob.dmi';
	icon_living = "shade";
	icon_state = "shade";
	icon_dead = "shade_dead";
	melee_damage_lower = 10;
	melee_damage_upper = 25
	},
/turf/simulated/floor/engine/cult,
/area/ruin/unpowered)
"Dp" = (
/turf/template_noop,
/area/template_noop)
"Dq" = (
/turf/simulated/wall/shuttle/nosmooth{
	dir = 9;
	icon_state = "white_walls_corners"
	},
/area/ruin/unpowered)
"Dz" = (
/turf/simulated/wall/shuttle/onlyselfsmooth,
/area/ruin/unpowered)
"EE" = (
/turf/simulated/wall/shuttle/nosmooth{
	dir = 5;
	icon_state = "white_walls_corners"
	},
/area/ruin/unpowered)
"EI" = (
/turf/simulated/floor/plating/asteroid/airless,
/area/ruin/unpowered)
"GR" = (
/turf/simulated/wall/shuttle/nosmooth{
	dir = 10;
	icon_state = "white_walls_corners"
	},
/area/ruin/unpowered)
"Hm" = (
/obj/effect/decal/remains/human,
/turf/simulated/floor/engine/cult,
/area/ruin/unpowered)
"Jn" = (
/obj/structure/bookcase,
/turf/simulated/floor/engine/cult,
/area/ruin/unpowered)
"Kp" = (
/obj/structure/table/wood/fancy/black,
/obj/item/storage/toolbox/mechanical{
	pixel_x = 4;
	pixel_y = -4
	},
/turf/simulated/floor/engine/cult,
/area/ruin/unpowered)
"KT" = (
/obj/structure/table/wood,
/obj/item/flashlight/lantern,
/turf/simulated/floor/engine/cult,
/area/ruin/unpowered)
"KY" = (
/obj/item/reagent_containers/food/drinks/bottle/unholywater,
/obj/effect/decal/cleanable/crayon{
	color = "#cc3300";
	desc = null
	},
/turf/simulated/floor/engine/cult,
/area/ruin/unpowered)
"Li" = (
/obj/machinery/power/port_gen/pacman,
/turf/simulated/floor/engine/cult,
/area/ruin/unpowered)
"Lp" = (
/obj/structure/cult/altar,
/turf/simulated/floor/engine/cult,
/area/ruin/unpowered)
"Mi" = (
/obj/structure/chair/comfy/shuttle,
/turf/simulated/floor/engine/cult,
/area/ruin/unpowered)
"Mt" = (
/obj/structure/computerframe,
/turf/simulated/floor/engine/cult,
/area/ruin/unpowered)
"MO" = (
/obj/item/clothing/suit/hooded/cultrobes,
/turf/simulated/floor/engine/cult,
/area/ruin/unpowered)
"MV" = (
/mob/living/simple_animal/hostile/carp,
/turf/space,
/area/space)
"NA" = (
/obj/effect/decal/remains/human,
/turf/simulated/floor/plating/asteroid/airless,
/area/ruin/unpowered)
"NF" = (
/obj/effect/decal/cleanable/blood/old,
/turf/simulated/floor/engine/cult,
/area/ruin/unpowered)
"NU" = (
/obj/effect/decal/cleanable/crayon{
	color = "#cc3300";
	desc = null
	},
/turf/simulated/floor/engine/cult,
/area/ruin/unpowered)
"Pz" = (
/turf/simulated/wall/shuttle/nosmooth{
	dir = 6;
	icon_state = "white_walls_corners"
	},
/area/ruin/unpowered)
"RD" = (
/obj/effect/decal/cleanable/blood/old,
/mob/living/simple_animal/hostile/illusion/cult{
	deathmessage = "disappears into the air with a cry of agony";
	desc = "The deceived soul";
	health = 350;
	maxHealth = 350;
	name = "The soul of the cultist";
	icon = 'icons/mob/mob.dmi';
	icon_living = "shade";
	icon_state = "shade";
	icon_dead = "shade_dead";
	melee_damage_lower = 10;
	melee_damage_upper = 25
	},
/turf/simulated/floor/engine/cult,
/area/ruin/unpowered)
"TZ" = (
/obj/structure/table/wood,
/obj/item/candle/eternal,
/turf/simulated/floor/engine/cult,
/area/ruin/unpowered)
"Uv" = (
/obj/structure/cult/forge,
/turf/simulated/floor/engine/cult,
/area/ruin/unpowered)
"UX" = (
/obj/structure/shuttle/engine/propulsion{
	dir = 1;
	tag = "icon-propulsion (NORTH)"
	},
/turf/simulated/floor/plating,
/area/ruin/unpowered)
"Vn" = (
/obj/structure/table/wood,
/obj/item/storage/firstaid/brute,
/turf/simulated/floor/engine/cult,
/area/ruin/unpowered)
"Wh" = (
/obj/item/clothing/head/helmet/space/cult,
/turf/simulated/floor/engine/cult,
/area/ruin/unpowered)
"WW" = (
/turf/simulated/floor/engine/cult,
/area/ruin/unpowered)
"Xi" = (
/obj/structure/cult/pylon,
/turf/simulated/floor/engine/cult,
/area/ruin/unpowered)
"Yt" = (
/obj/structure/table/wood/fancy/black,
/obj/item/candle/eternal,
/obj/effect/temp_visual/cult/sparks,
/turf/simulated/floor/engine/cult,
/area/ruin/unpowered)

(1,1,1) = {"
Dp
Dp
Dp
Dp
Dp
Dp
Dp
Dp
Dp
Dp
Dp
Dp
Dp
Dp
Dp
Dp
Dp
Dp
Dp
Dp
Dp
Dp
Dp
Dp
Dp
Dp
Dp
Dp
Dp
Dp
Dp
Dp
Dp
Dp
Dp
Dp
Dp
Dp
Dp
Dp
Dp
Dp
Dp
Dp
Dp
"}
(2,1,1) = {"
Dp
xv
xv
xv
xv
xv
xv
xv
xv
xv
xv
xv
xv
xv
xv
xv
xv
xv
xv
xv
xv
xv
xv
xv
xv
xv
xv
xv
xv
xv
xv
xv
xv
xv
xv
xv
xv
xv
xv
xv
xv
xv
xv
xv
Dp
"}
(3,1,1) = {"
Dp
xv
xv
xv
xv
xv
xv
xv
xv
xv
xv
xv
xv
xv
xv
xv
xv
xv
xv
xv
xv
xv
xv
xv
xv
xv
xv
xv
xv
xv
xv
EI
EI
xv
xv
xv
xv
xv
xv
xv
xv
xv
xv
xv
Dp
"}
(4,1,1) = {"
Dp
xv
xv
xv
xv
xv
xv
xv
xv
xv
xv
xv
xv
xv
xv
xv
xv
xv
xv
xv
xv
xv
xv
xv
xv
xv
xv
xv
xv
oc
oc
oc
oc
oc
EI
xv
xv
xv
xv
xv
xv
xv
xv
xv
Dp
"}
(5,1,1) = {"
Dp
xv
xv
xv
xv
xv
xv
xv
xv
xv
xv
EI
EI
xv
xv
xv
xv
xv
xv
xv
xv
xv
xv
xv
xv
xv
xv
oc
oc
oc
oc
oc
oc
oc
oc
EI
EI
EI
xv
xv
xv
xv
xv
xv
Dp
"}
(6,1,1) = {"
Dp
xv
xv
xv
xv
xv
xv
xv
xv
xv
EI
EI
EI
EI
xv
xv
xv
xv
xv
xv
xv
xv
xv
xv
xv
xv
xv
oc
oc
oc
yu
yu
yu
yu
oc
oc
EI
EI
xv
xv
xv
xv
xv
xv
Dp
"}
(7,1,1) = {"
Dp
xv
xv
xv
xv
xv
xv
xv
xv
EI
EI
EI
EI
EI
xv
xv
xv
xv
xv
xv
xv
xv
xv
xv
xv
EI
oc
oc
oc
yu
WW
CO
WW
WW
yu
oc
oc
EI
EI
xv
xv
xv
xv
xv
Dp
"}
(8,1,1) = {"
Dp
xv
xv
xv
xv
xv
xv
xv
xv
EI
oc
oc
oc
EI
EI
xv
xv
xv
xv
xv
xv
xv
xv
xv
EI
oc
oc
oc
yu
oo
WW
Hm
WW
WW
yu
oc
oc
oc
EI
EI
xv
xv
xv
xv
Dp
"}
(9,1,1) = {"
Dp
xv
xv
xv
xv
xv
xv
xv
EI
EI
oc
oc
EI
EI
EI
xv
xv
MV
xv
xv
xv
xv
xv
xv
EI
oc
oc
yu
Cj
RD
NU
xZ
NU
Wh
WW
yu
oc
oc
oc
EI
EI
xv
xv
xv
Dp
"}
(10,1,1) = {"
Dp
xv
xv
xv
xv
xv
xv
xv
xv
EI
EI
EI
EI
EI
xv
xv
xv
xv
xv
xv
xv
xv
xv
EI
EI
oc
yu
WW
WW
NU
WW
WW
WW
NU
WW
WW
yu
oc
oc
oc
EI
xv
xv
xv
Dp
"}
(11,1,1) = {"
Dp
xv
MV
xv
xv
xv
xv
xv
xv
xv
EI
EI
EI
xv
xv
xv
xv
xv
xv
xv
xv
xv
xv
EI
EI
oc
yu
WW
Hm
xZ
WW
Bs
WW
xZ
WW
WW
yu
oc
oc
oc
EI
xv
xv
xv
Dp
"}
(12,1,1) = {"
Dp
xv
xv
xv
xv
xv
xv
xv
xv
xv
xv
EI
xv
xv
xv
xv
xv
xv
xv
xv
xv
xv
EI
EI
EI
oc
yu
WW
WW
NU
WW
WW
WW
NU
WW
WW
yu
oc
oc
oc
xv
xv
xv
xv
Dp
"}
(13,1,1) = {"
Dp
xv
xv
xv
xv
xv
xv
xv
xv
xv
xv
xv
xv
xv
xv
xv
xv
xv
xv
xv
xv
xv
xv
EI
EI
oc
oc
yu
WW
WW
KY
xZ
NU
vW
MO
yu
oc
oc
oc
oc
xv
xv
xv
xv
Dp
"}
(14,1,1) = {"
Dp
xv
xv
xv
xv
xv
xv
xv
xv
xv
xv
xv
xv
xv
xv
xv
xv
xv
xv
xv
xv
xv
xv
EI
EI
EI
oc
oc
yu
NF
WW
Hm
WW
RD
yu
oc
oc
oc
EI
EI
xv
xv
xv
xv
Dp
"}
(15,1,1) = {"
Dp
xv
xv
xv
xv
xv
xv
xv
xv
xv
xv
xv
xv
xv
xv
xv
xv
xv
xv
xv
xv
xv
xv
xv
EI
EI
EI
oc
oc
yu
Xi
WW
WW
Xi
yu
oc
oc
EI
EI
xv
xv
xv
xv
xv
Dp
"}
(16,1,1) = {"
Dp
xv
xv
xv
xv
xv
xv
xv
xv
xv
xv
xv
xv
xv
xv
xv
xv
xv
xv
xv
xv
xv
xv
xv
xv
EI
EI
EI
oc
oc
yu
lw
lw
yu
oc
oc
EI
xv
xv
xv
xv
xv
xv
xv
Dp
"}
(17,1,1) = {"
Dp
xv
xv
xv
xv
xv
xv
xv
xv
xv
xv
xv
xv
xv
xv
xv
xv
xv
xv
xv
xv
xv
xv
xv
xv
xv
EI
EI
EI
oc
oc
oc
oc
oc
oc
EI
EI
xv
xv
xv
xv
xv
xv
xv
Dp
"}
(18,1,1) = {"
Dp
xv
xv
xv
xv
xv
xv
xv
xv
xv
xv
xv
xv
xv
Dq
Cb
jV
Cb
GR
xv
xv
xv
xv
xv
xv
xv
xv
EI
EI
EI
oc
oc
oc
EI
EI
xv
xv
xv
xv
xv
xv
xv
xv
xv
Dp
"}
(19,1,1) = {"
Dp
xv
xv
xv
xv
xv
xv
xv
Dq
sW
Dz
Cb
sW
Dz
sW
WW
WW
WW
sW
Dz
sW
Dz
GR
xv
xv
xv
xv
xv
xv
xv
EI
EI
EI
xv
xv
xv
xv
xv
xv
xv
xv
xv
xv
xv
Dp
"}
(20,1,1) = {"
Dp
xv
xv
xv
xv
xv
xv
Dq
Dz
sW
Uv
Uv
CO
Xi
sW
Bg
WW
WW
sW
Yt
AW
Yt
sW
GR
xv
xv
xv
xv
xv
xv
xv
NA
xv
xv
xv
xv
xv
xv
xv
xv
xv
xv
xv
xv
Dp
"}
(21,1,1) = {"
Dp
xv
xv
xv
xv
xv
Dq
Dz
WW
sW
NF
NF
WW
WW
sW
Cb
jV
Cb
sW
pf
WW
WW
WW
Dz
GR
xv
xv
xv
xv
xv
xv
xv
xv
xv
xv
xv
xv
xv
xv
xv
xv
xv
xv
xv
Dp
"}
(22,1,1) = {"
Dp
xv
xv
xv
Dq
Dz
sW
WW
WW
sW
Bg
WW
WW
WW
WW
WW
WW
WW
sW
WW
WW
Hm
WW
WW
sW
GR
xv
xv
xv
EI
EI
xv
xv
xv
xv
xv
xv
xv
xv
xv
xv
xv
xv
xv
Dp
"}
(23,1,1) = {"
Dp
xv
xv
UX
vK
sW
Li
NF
WW
sW
WW
WW
Bg
WW
WW
WW
WW
WW
Bg
sW
WW
CT
WW
WW
WW
Dz
GR
xv
EI
EI
EI
EI
EI
xv
xv
xv
xv
xv
xv
xv
xv
xv
xv
xv
Dp
"}
(24,1,1) = {"
Dp
xv
xv
UX
vK
Dz
Li
NF
WW
sW
WW
Hm
qE
KT
TZ
WW
WW
WW
WW
WW
sW
WW
WW
WW
Mi
Mt
Cb
EI
EI
EI
EI
EI
EI
EI
xv
xv
xv
xv
xv
xv
xv
xv
xv
xv
Dp
"}
(25,1,1) = {"
Dp
xv
xv
UX
vK
sW
Li
NF
Bg
jV
WW
NF
Vn
pf
pj
WW
WW
NF
WW
WW
jV
WW
WW
WW
Mi
Mt
Cb
EI
oc
EI
EI
EI
EI
EI
xv
xv
xv
xv
xv
xv
xv
xv
xv
xv
Dp
"}
(26,1,1) = {"
Dp
xv
xv
UX
vK
Dz
Li
kg
WW
sW
WW
WW
KT
ge
TZ
WW
WW
Hm
WW
WW
sW
WW
CT
Hm
Mi
Mt
Cb
EI
EI
EI
EI
EI
EI
EI
xv
xv
xv
xv
xv
xv
xv
xv
xv
xv
Dp
"}
(27,1,1) = {"
Dp
xv
xv
UX
vK
sW
Li
NF
WW
sW
Jn
WW
WW
WW
WW
WW
WW
WW
WW
sW
WW
WW
WW
WW
WW
Dz
Pz
EI
EI
EI
EI
EI
EI
xv
xv
xv
xv
xv
xv
xv
xv
xv
xv
xv
Dp
"}
(28,1,1) = {"
Dp
xv
xv
xv
EE
Dz
sW
WW
WW
sW
Jn
WW
WW
WW
WW
WW
WW
WW
sW
WW
WW
Hm
WW
WW
sW
Pz
xv
xv
EI
EI
EI
EI
xv
xv
xv
xv
xv
xv
xv
xv
xv
xv
xv
xv
Dp
"}
(29,1,1) = {"
Dp
xv
xv
xv
xv
xv
EE
sW
nl
sW
NF
dJ
WW
WW
sW
Cb
jV
Cb
sW
pf
WW
WW
WW
Dz
Pz
xv
xv
xv
xv
EI
EI
xv
xv
xv
xv
xv
xv
xv
xv
xv
xv
xv
xv
xv
Dp
"}
(30,1,1) = {"
Dp
xv
xv
xv
xv
xv
xv
EE
sW
sW
Lp
Lp
iG
Xi
sW
Bg
WW
WW
sW
Yt
Kp
Yt
sW
Pz
xv
xv
xv
xv
xv
xv
xv
xv
xv
xv
xv
xv
xv
xv
xv
xv
xv
xv
xv
xv
Dp
"}
(31,1,1) = {"
Dp
xv
xv
xv
xv
xv
xv
xv
EE
Dz
sW
Cb
Cb
Dz
sW
WW
WW
WW
sW
Dz
CJ
Dz
Pz
xv
xv
xv
xv
xv
xv
xv
xv
xv
xv
xv
xv
xv
xv
xv
xv
xv
MV
xv
xv
xv
Dp
"}
(32,1,1) = {"
Dp
xv
xv
xv
xv
xv
xv
xv
xv
xv
xv
xv
xv
xv
EE
Cb
jV
Cb
Pz
xv
xv
xv
xv
xv
xv
xv
EI
EI
oc
oc
xv
xv
xv
xv
xv
xv
xv
xv
xv
xv
xv
xv
xv
xv
Dp
"}
(33,1,1) = {"
Dp
xv
xv
xv
xv
xv
xv
xv
xv
xv
xv
xv
xv
xv
xv
xv
xv
xv
xv
xv
xv
xv
xv
xv
xv
EI
EI
oc
oc
oc
EI
xv
xv
xv
xv
xv
xv
xv
xv
xv
xv
xv
xv
xv
Dp
"}
(34,1,1) = {"
Dp
xv
xv
xv
xv
xv
xv
xv
xv
xv
xv
xv
xv
xv
xv
xv
xv
xv
xv
xv
xv
xv
xv
xv
xv
EI
oc
oc
oc
oc
EI
EI
xv
xv
xv
xv
xv
xv
xv
xv
EI
EI
xv
xv
Dp
"}
(35,1,1) = {"
Dp
xv
xv
xv
xv
xv
xv
xv
xv
xv
xv
xv
xv
xv
xv
xv
xv
xv
xv
xv
xv
xv
xv
xv
EI
oc
oc
oc
oc
EI
EI
EI
xv
xv
xv
xv
xv
xv
xv
EI
EI
EI
EI
xv
Dp
"}
(36,1,1) = {"
Dp
xv
xv
xv
xv
xv
xv
xv
xv
xv
xv
xv
xv
xv
EI
xv
xv
xv
xv
xv
xv
xv
xv
xv
EI
oc
EI
EI
EI
EI
EI
xv
xv
xv
xv
xv
xv
xv
EI
EI
EI
oc
oc
EI
Dp
"}
(37,1,1) = {"
Dp
xv
xv
xv
xv
xv
xv
xv
xv
xv
xv
xv
EI
EI
EI
EI
xv
xv
xv
xv
xv
xv
xv
xv
xv
EI
EI
EI
EI
EI
xv
xv
xv
xv
xv
xv
xv
EI
EI
oc
oc
oc
oc
EI
Dp
"}
(38,1,1) = {"
Dp
xv
xv
xv
xv
xv
xv
xv
xv
xv
xv
EI
EI
EI
EI
EI
EI
xv
xv
xv
xv
xv
xv
xv
xv
xv
EI
EI
EI
xv
xv
xv
xv
xv
xv
xv
xv
xv
EI
oc
oc
oc
EI
EI
Dp
"}
(39,1,1) = {"
Dp
xv
xv
xv
xv
xv
xv
xv
xv
xv
EI
EI
EI
oc
EI
EI
EI
xv
xv
xv
xv
xv
xv
xv
xv
xv
xv
xv
xv
xv
xv
xv
xv
xv
xv
xv
xv
xv
EI
EI
oc
oc
EI
EI
Dp
"}
(40,1,1) = {"
Dp
xv
xv
xv
xv
xv
xv
xv
xv
xv
xv
EI
EI
oc
oc
oc
EI
EI
xv
xv
xv
xv
xv
xv
xv
xv
xv
xv
xv
MV
xv
xv
xv
xv
xv
xv
xv
xv
xv
EI
EI
EI
EI
xv
Dp
"}
(41,1,1) = {"
Dp
xv
xv
xv
xv
MV
xv
xv
xv
xv
xv
EI
EI
oc
oc
EI
EI
xv
xv
xv
xv
xv
xv
xv
xv
xv
xv
xv
xv
xv
xv
xv
xv
xv
xv
xv
xv
xv
xv
xv
EI
EI
xv
xv
Dp
"}
(42,1,1) = {"
Dp
xv
xv
xv
xv
xv
xv
xv
xv
xv
xv
xv
EI
EI
EI
EI
xv
xv
xv
xv
xv
xv
xv
xv
xv
xv
xv
xv
xv
xv
xv
xv
xv
xv
xv
xv
xv
xv
xv
xv
xv
xv
xv
xv
Dp
"}
(43,1,1) = {"
Dp
xv
xv
xv
xv
xv
xv
xv
xv
xv
xv
xv
xv
xv
xv
xv
xv
xv
xv
xv
xv
xv
xv
xv
xv
xv
xv
xv
xv
xv
xv
xv
xv
xv
xv
xv
xv
xv
xv
xv
xv
xv
xv
xv
Dp
"}
(44,1,1) = {"
Dp
xv
xv
xv
xv
xv
xv
xv
xv
xv
xv
xv
xv
xv
xv
xv
xv
xv
xv
xv
xv
xv
xv
xv
xv
xv
xv
xv
xv
xv
xv
xv
xv
xv
xv
xv
xv
xv
xv
xv
xv
xv
xv
xv
Dp
"}
(45,1,1) = {"
Dp
Dp
Dp
Dp
Dp
Dp
Dp
Dp
Dp
Dp
Dp
Dp
Dp
Dp
Dp
Dp
Dp
Dp
Dp
Dp
Dp
Dp
Dp
Dp
Dp
Dp
Dp
Dp
Dp
Dp
Dp
Dp
Dp
Dp
Dp
Dp
Dp
Dp
Dp
Dp
Dp
Dp
Dp
Dp
Dp
"}
