//MAP CONVERTED BY dmm2tgm.py THIS HEADER COMMENT PREVENTS RECONVERSION, DO NOT REMOVE
"aM" = (
/obj/machinery/light/small{
	dir = 1
	},
/obj/structure/dispenser/oxygen,
/obj/effect/decal/cleanable/dirt,
/turf/simulated/floor/plasteel,
/area/ruin/unpowered)
"bb" = (
/obj/machinery/gibber/autogibber,
/obj/structure/plasticflaps,
/obj/machinery/conveyor{
	id = "syndiecake";
	dir = 4
	},
/obj/effect/decal/cleanable/dirt,
/turf/simulated/floor/plasteel,
/area/ruin/unpowered)
"bk" = (
/turf/simulated/floor/plating/airless,
/area/space)
"es" = (
/obj/machinery/conveyor{
	id = "syndiecake";
	dir = 4
	},
/obj/effect/decal/cleanable/dirt,
/turf/simulated/floor/plasteel,
/area/ruin/unpowered)
"fq" = (
/obj/structure/grille/broken,
/turf/space,
/area/space)
"fU" = (
/obj/machinery/power/smes,
/obj/structure/cable/blue{
	d2 = 2;
	icon_state = "0-2"
	},
/obj/effect/decal/cleanable/dirt,
/turf/simulated/floor/plasteel,
/area/ruin/unpowered)
"fY" = (
/obj/machinery/conveyor{
	id = "syndiecake";
	dir = 4
	},
/obj/effect/decal/cleanable/dirt,
/turf/simulated/floor/plasteel/airless,
/area/ruin)
"hm" = (
/obj/machinery/conveyor{
	id = "syndiecake"
	},
/turf/simulated/floor/plasteel/airless,
/area/space)
"ho" = (
/mob/living/simple_animal/pet/dog/corgi,
/obj/machinery/conveyor{
	id = "syndiecake";
	dir = 4
	},
/obj/effect/decal/cleanable/dirt,
/turf/simulated/floor/plasteel,
/area/ruin/unpowered)
"iK" = (
/obj/item/stack/cable_coil/random,
/obj/effect/decal/cleanable/dirt,
/turf/simulated/floor/plasteel/airless,
/area/ruin/unpowered)
"jf" = (
/obj/machinery/conveyor{
	id = "syndiecake";
	dir = 1
	},
/obj/effect/decal/cleanable/dirt,
/turf/simulated/floor/plasteel,
/area/ruin/unpowered)
"jR" = (
/obj/structure/cable{
	d2 = 4;
	icon_state = "0-4"
	},
/obj/machinery/power/port_gen/pacman,
/obj/effect/decal/cleanable/dirt,
/turf/simulated/floor/plasteel,
/area/ruin/unpowered)
"kh" = (
/obj/structure/table/reinforced,
/obj/item/storage/fancy/cigarettes/cigpack_random,
/obj/effect/decal/cleanable/dirt,
/turf/simulated/floor/plasteel,
/area/ruin/unpowered)
"ky" = (
/obj/machinery/suit_storage_unit/syndicate,
/obj/effect/decal/cleanable/dirt,
/turf/simulated/floor/plasteel,
/area/ruin/unpowered)
"ls" = (
/obj/structure/lattice/catwalk,
/turf/space,
/area/space)
"lK" = (
/obj/item/trash/syndi_cakes,
/obj/effect/decal/cleanable/dirt,
/turf/simulated/floor/plasteel,
/area/ruin/unpowered)
"mu" = (
/obj/structure/lattice,
/obj/item/stack/rods,
/turf/space,
/area/space)
"nV" = (
/obj/structure/grille/broken,
/turf/space,
/area/ruin/space)
"ob" = (
/obj/item/reagent_containers/food/snacks/syndicake,
/obj/effect/decal/cleanable/dirt,
/turf/simulated/floor/plasteel/airless,
/area/ruin/space)
"om" = (
/obj/structure/table/reinforced,
/obj/item/reagent_containers/food/snacks/syndicake,
/obj/effect/decal/cleanable/dirt,
/turf/simulated/floor/plasteel,
/area/ruin/unpowered)
"oJ" = (
/obj/structure/table/reinforced,
/obj/item/stack/sheet/mineral/plasma,
/obj/item/stack/sheet/mineral/plasma,
/obj/effect/decal/cleanable/dirt,
/turf/simulated/floor/plasteel,
/area/ruin/unpowered)
"oO" = (
/turf/simulated/floor/plating/airless,
/area/ruin)
"pb" = (
/obj/structure/cable{
	icon_state = "1-2";
	tag = ""
	},
/obj/effect/decal/cleanable/dirt,
/turf/simulated/floor/plasteel/airless,
/area/ruin/unpowered)
"pd" = (
/obj/item/stack/sheet/metal,
/turf/space,
/area/space)
"pp" = (
/obj/machinery/power/terminal{
	dir = 4
	},
/obj/structure/cable{
	d2 = 8;
	icon_state = "0-8"
	},
/obj/effect/decal/cleanable/dirt,
/turf/simulated/floor/plasteel,
/area/ruin/unpowered)
"qA" = (
/obj/item/stack/sheet/metal,
/obj/item/stack/sheet/metal,
/turf/space,
/area/space)
"qS" = (
/obj/structure/table/reinforced,
/obj/item/storage/toolbox/syndicate,
/obj/effect/decal/cleanable/dirt,
/turf/simulated/floor/plasteel,
/area/ruin/unpowered)
"rG" = (
/obj/machinery/light{
	dir = 8
	},
/obj/item/trash/syndi_cakes,
/obj/effect/decal/cleanable/dirt,
/turf/simulated/floor/plasteel,
/area/ruin/unpowered)
"rJ" = (
/obj/structure/lattice,
/turf/space,
/area/ruin/space)
"rL" = (
/obj/machinery/door/airlock/mining/glass{
	locked = 1;
	max_integrity = 300000;
	name = "Corgi processing";
	normal_integrity = 300000
	},
/obj/effect/decal/cleanable/dirt,
/turf/simulated/floor/plasteel,
/area/ruin/unpowered)
"sd" = (
/obj/structure/table/reinforced,
/obj/machinery/light,
/obj/effect/decal/cleanable/dirt,
/turf/simulated/floor/plasteel,
/area/ruin/unpowered)
"sN" = (
/mob/living/simple_animal/pet/dog/corgi,
/mob/living/simple_animal/pet/dog/corgi,
/obj/machinery/conveyor{
	id = "syndiecake";
	dir = 4
	},
/obj/effect/decal/cleanable/dirt,
/turf/simulated/floor/plasteel,
/area/ruin/unpowered)
"tz" = (
/obj/structure/cable{
	icon_state = "1-8";
	tag = ""
	},
/obj/structure/cable{
	icon_state = "1-4";
	tag = "90Curve"
	},
/obj/effect/decal/cleanable/dirt,
/turf/simulated/floor/plasteel,
/area/ruin/unpowered)
"ub" = (
/obj/structure/lattice,
/obj/item/stack/sheet/metal,
/turf/space,
/area/space)
"uA" = (
/obj/item/stack/rods,
/obj/item/stack/sheet/metal,
/turf/space,
/area/space)
"uF" = (
/obj/structure/cable{
	icon_state = "1-2";
	tag = ""
	},
/turf/simulated/wall,
/area/ruin/unpowered)
"vV" = (
/obj/effect/decal/cleanable/dirt,
/turf/simulated/floor/plasteel,
/area/ruin/unpowered)
"xT" = (
/obj/machinery/conveyor_switch/oneway{
	id = "syndiecake"
	},
/obj/effect/decal/cleanable/dirt,
/turf/simulated/floor/plasteel,
/area/ruin/unpowered)
"yS" = (
/obj/item/trash/syndi_cakes,
/turf/space,
/area/space)
"yU" = (
/obj/structure/cable{
	icon_state = "4-8";
	tag = ""
	},
/obj/effect/decal/cleanable/dirt,
/turf/simulated/floor/plasteel/airless,
/area/ruin/unpowered)
"zd" = (
/obj/machinery/space_heater,
/obj/effect/decal/cleanable/dirt,
/turf/simulated/floor/plasteel,
/area/ruin/unpowered)
"zo" = (
/obj/structure/lattice,
/turf/space,
/area/ruin)
"zt" = (
/obj/effect/spawner/random_spawners/wall_rusted_70,
/turf/simulated/wall,
/area/space)
"zF" = (
/obj/machinery/conveyor{
	id = "syndiecake";
	dir = 5
	},
/obj/effect/decal/cleanable/dirt,
/turf/simulated/floor/plasteel,
/area/ruin/unpowered)
"zP" = (
/obj/structure/cable{
	icon_state = "2-8"
	},
/obj/effect/decal/cleanable/dirt,
/turf/simulated/floor/plasteel,
/area/ruin/unpowered)
"zY" = (
/obj/effect/spawner/random_spawners/syndicate/loot,
/obj/effect/decal/cleanable/dirt,
/turf/simulated/floor/plasteel,
/area/ruin/unpowered)
"At" = (
/obj/machinery/door/airlock/mining/glass{
	locked = 1;
	name = "Manufacturing Control Room"
	},
/turf/simulated/floor/plasteel/airless,
/area/ruin/unpowered)
"AH" = (
/obj/machinery/light{
	dir = 8
	},
/obj/effect/decal/cleanable/dirt,
/turf/simulated/floor/plasteel/airless,
/area/ruin/unpowered)
"AJ" = (
/obj/machinery/door/airlock/mining/glass{
	name = "EVA Storage"
	},
/obj/structure/cable{
	icon_state = "4-8";
	tag = ""
	},
/obj/effect/decal/cleanable/dirt,
/turf/simulated/floor/plasteel/airless,
/area/ruin/unpowered)
"BG" = (
/turf/space,
/area/ruin/unpowered)
"BI" = (
/obj/structure/cable{
	icon_state = "4-8";
	tag = ""
	},
/obj/effect/decal/cleanable/dirt,
/turf/simulated/floor/plasteel,
/area/ruin/unpowered)
"Cp" = (
/obj/structure/lattice,
/turf/space,
/area/ruin/unpowered)
"CY" = (
/obj/item/stack/cable_coil/cut,
/turf/space,
/area/space)
"Da" = (
/turf/space,
/area/space)
"Ec" = (
/obj/structure/lattice,
/obj/random/tool,
/turf/space,
/area/space)
"EJ" = (
/turf/simulated/wall,
/area/ruin/unpowered)
"Fw" = (
/obj/structure/cable{
	icon_state = "1-8"
	},
/obj/effect/decal/cleanable/dirt,
/turf/simulated/floor/plasteel/airless,
/area/ruin/unpowered)
"FO" = (
/obj/machinery/conveyor{
	id = "syndiecake"
	},
/obj/effect/decal/cleanable/dirt,
/turf/simulated/floor/plasteel/airless,
/area/ruin)
"GB" = (
/obj/machinery/light{
	dir = 8
	},
/obj/effect/decal/cleanable/dirt,
/turf/simulated/floor/plasteel,
/area/ruin/unpowered)
"He" = (
/obj/machinery/conveyor{
	id = "syndiecake";
	dir = 4
	},
/turf/simulated/floor/plasteel/airless,
/area/space)
"Hx" = (
/obj/item/stack/rods,
/turf/space,
/area/space)
"Hy" = (
/turf/template_noop,
/area/template_noop)
"Ic" = (
/obj/structure/rack{
	dir = 4
	},
/obj/random/tool,
/obj/effect/decal/cleanable/dirt,
/turf/simulated/floor/plasteel,
/area/ruin/unpowered)
"Id" = (
/obj/machinery/autolathe,
/obj/effect/decal/cleanable/dirt,
/turf/simulated/floor/plasteel,
/area/ruin/unpowered)
"IB" = (
/turf/simulated/floor/plating/airless,
/area/ruin/space)
"JI" = (
/obj/structure/chair/office/dark{
	dir = 4;
	tag = "icon-officechair_dark (EAST)"
	},
/obj/effect/decal/cleanable/dirt,
/turf/simulated/floor/plasteel,
/area/ruin/unpowered)
"Ki" = (
/mob/living/simple_animal/pet/dog/corgi,
/obj/machinery/conveyor_switch/oneway{
	id = "syndiecake"
	},
/obj/effect/decal/cleanable/dirt,
/turf/simulated/floor/plasteel,
/area/ruin/unpowered)
"Kr" = (
/obj/effect/decal/cleanable/dirt,
/turf/simulated/floor/plasteel/airless,
/area/ruin/space)
"KD" = (
/obj/machinery/tcomms/relay/ruskie{
	network_id = "SYNDICAKES-FACTORY"
	},
/obj/effect/decal/cleanable/dirt,
/turf/simulated/floor/plasteel,
/area/ruin/unpowered)
"Mi" = (
/obj/structure/chair/office/dark,
/obj/effect/decal/cleanable/dirt,
/turf/simulated/floor/plasteel,
/area/ruin/unpowered)
"Mz" = (
/obj/effect/decal/cleanable/dirt,
/turf/simulated/floor/plasteel/airless,
/area/ruin/unpowered)
"Nw" = (
/obj/structure/cable{
	icon_state = "1-2"
	},
/obj/effect/decal/cleanable/dirt,
/turf/simulated/floor/plasteel,
/area/ruin/unpowered)
"NQ" = (
/obj/structure/lattice,
/turf/space,
/area/space)
"OA" = (
/obj/item/reagent_containers/food/snacks/syndicake,
/obj/item/reagent_containers/food/snacks/syndicake,
/obj/item/reagent_containers/food/snacks/syndicake,
/obj/item/reagent_containers/food/snacks/syndicake,
/obj/item/reagent_containers/food/snacks/syndicake,
/obj/item/reagent_containers/food/snacks/syndicake,
/obj/effect/decal/cleanable/dirt,
/turf/simulated/floor/plasteel/airless,
/area/space)
"OK" = (
/obj/item/reagent_containers/food/snacks/syndicake,
/turf/space,
/area/space)
"OU" = (
/obj/structure/table/reinforced,
/turf/simulated/floor/plasteel/airless,
/area/ruin/unpowered)
"QF" = (
/obj/structure/reagent_dispensers/fueltank,
/obj/effect/decal/cleanable/dirt,
/turf/simulated/floor/plasteel,
/area/ruin/unpowered)
"QI" = (
/obj/structure/closet/emcloset,
/obj/effect/decal/cleanable/dirt,
/turf/simulated/floor/plasteel,
/area/ruin/unpowered)
"Ry" = (
/obj/machinery/door/airlock/mining/glass{
	name = "Nexus"
	},
/obj/effect/decal/cleanable/dirt,
/turf/simulated/floor/plasteel/airless,
/area/ruin/unpowered)
"RB" = (
/mob/living/simple_animal/hostile/alien/sentinel{
	animal_species = /mob/living/simple_animal/pet/dog;
	attack_sound = 'sound/weapons/bite.ogg';
	attacktext = "кусает";
	damage_coeff = list("brute"=1,"fire"=1,"tox"=1,"clone"=1,"stamina"=1,"oxy"=1);
	death_sound = null;
	deathmessage = "";
	desc = "This is no longer a goodboy. Not anymore. He has seen too much.";
	icon = 'icons/mob/pets.dmi';
	icon_living = "corgi";
	icon_state = "corgi";
	name = "angry corgi";
	retreat_distance = 2
	},
/obj/effect/decal/cleanable/dirt,
/turf/simulated/floor/plasteel,
/area/ruin/unpowered)
"Tj" = (
/obj/machinery/conveyor/inverted{
	id = "syndiecake";
	dir = 10
	},
/obj/effect/decal/cleanable/dirt,
/turf/simulated/floor/plasteel,
/area/ruin/unpowered)
"Tt" = (
/obj/machinery/light{
	dir = 4
	},
/obj/effect/decal/cleanable/dirt,
/turf/simulated/floor/plasteel/airless,
/area/ruin/unpowered)
"TM" = (
/obj/effect/spawner/random_spawners/wall_rusted_70,
/turf/simulated/wall,
/area/ruin)
"TT" = (
/obj/effect/spawner/random_spawners/oil_20,
/obj/effect/decal/cleanable/dirt,
/turf/simulated/floor/plasteel,
/area/ruin/unpowered)
"Uq" = (
/obj/effect/decal/cleanable/dirt,
/turf/simulated/floor/plasteel/airless,
/area/ruin)
"UC" = (
/obj/docking_port/stationary{
	dir = 4;
	dwidth = 2;
	height = 5;
	id = "sindiecake_dock";
	name = "Docking port Syndicake Factory";
	width = 8
	},
/turf/space,
/area/space)
"UR" = (
/obj/machinery/door/airlock/external,
/turf/simulated/floor/plating/airless,
/area/ruin/powered)
"Vf" = (
/obj/machinery/power/apc/noalarm{
	dir = 8;
	keep_preset_name = 1;
	locked = 0;
	name = "EVA room APC";
	pixel_x = -24;
	start_charge = -1
	},
/obj/structure/cable{
	d2 = 4;
	icon_state = "0-4"
	},
/obj/effect/decal/cleanable/dirt,
/turf/simulated/floor/plasteel,
/area/ruin/unpowered)
"Vt" = (
/turf/simulated/wall/indestructible/fakeglass,
/area/ruin/unpowered)
"VH" = (
/turf/simulated/wall,
/area/space)
"VR" = (
/obj/structure/girder,
/turf/simulated/floor/plating/airless,
/area/ruin/unpowered)
"WL" = (
/turf/space,
/area/ruin/space)
"Xd" = (
/obj/machinery/power/apc/noalarm{
	dir = 8;
	keep_preset_name = 1;
	light_power = 0;
	locked = 0;
	max_integrity = 0;
	name = "Manufacturing control room  APC";
	pixel_y = -24;
	shorted = 1;
	start_charge = -1
	},
/obj/structure/cable{
	d2 = 4;
	icon_state = "0-4"
	},
/obj/effect/decal/cleanable/dirt,
/turf/simulated/floor/plasteel,
/area/ruin/unpowered)
"Xn" = (
/obj/machinery/door/airlock/mining/glass{
	locked = 1;
	name = "Egg processing"
	},
/obj/effect/decal/cleanable/dirt,
/turf/simulated/floor/plasteel/airless,
/area/ruin/unpowered)
"XZ" = (
/obj/item/stack/sheet/metal,
/obj/item/stack/sheet/metal,
/turf/space,
/area/ruin/space)
"YR" = (
/turf/simulated/floor/plating/airless,
/area/ruin/unpowered)
"YT" = (
/obj/item/reagent_containers/food/snacks/syndicake,
/obj/item/reagent_containers/food/snacks/syndicake,
/obj/item/reagent_containers/food/snacks/syndicake,
/turf/simulated/floor/plating/airless,
/area/space)
"YU" = (
/obj/structure/computerframe,
/obj/effect/decal/cleanable/dirt,
/turf/simulated/floor/plasteel,
/area/ruin/unpowered)
"Zs" = (
/mob/living/simple_animal/pet/dog/corgi,
/obj/effect/decal/cleanable/dirt,
/turf/simulated/floor/plasteel,
/area/ruin/unpowered)
"Zt" = (
/obj/structure/lattice,
/turf/simulated/floor/plating/airless,
/area/space)

(1,1,1) = {"
Hy
Hy
Hy
Hy
Hy
Hy
Hy
Hy
Hy
Hy
Hy
Hy
Hy
Hy
Hy
Hy
Hy
Hy
Hy
Hy
Hy
Hy
Hy
Hy
Hy
Hy
Hy
Hy
Hy
Hy
Hy
Hy
Hy
Hy
Hy
Hy
Hy
Hy
Hy
Hy
"}
(2,1,1) = {"
Hy
Da
Da
Da
Da
Da
Da
Da
Da
Da
Da
Da
Da
Da
Da
Da
Da
Da
Da
Da
Da
Da
Da
Da
Da
Da
Da
Da
Da
Da
Da
Da
Da
Da
Da
Da
Da
Da
Da
Hy
"}
(3,1,1) = {"
Hy
Da
Da
Da
Da
Da
Cp
Cp
Cp
Cp
Cp
Cp
EJ
EJ
EJ
EJ
EJ
EJ
EJ
EJ
NQ
NQ
NQ
Da
Da
Da
Da
Da
Da
Da
Da
Da
Da
Da
Da
Da
Da
Da
Da
Hy
"}
(4,1,1) = {"
Hy
Da
Da
Da
Da
Da
EJ
EJ
EJ
EJ
EJ
EJ
EJ
jR
GB
Vf
zd
vV
ky
EJ
EJ
EJ
ls
Da
Da
Da
Da
Da
Da
Da
Da
Da
Da
Da
Da
Da
Da
Da
Da
Hy
"}
(5,1,1) = {"
Hy
Da
Da
Da
Da
Da
EJ
zY
Ki
GB
xT
vV
EJ
pp
vV
BI
vV
vV
vV
UR
YR
UR
ls
ls
Da
Da
Da
Da
Da
Da
Da
Da
Da
Da
Da
Da
Da
Da
Da
Hy
"}
(6,1,1) = {"
Hy
Da
Da
Da
Da
Da
EJ
vV
sN
Zs
ho
vV
EJ
fU
Nw
tz
TT
vV
QI
EJ
EJ
EJ
ls
Da
Da
Da
Da
Da
Da
Da
Da
Da
Da
Da
Da
Da
Da
Da
Da
Hy
"}
(7,1,1) = {"
Hy
Da
Da
Da
Da
Da
EJ
vV
ho
vV
ho
vV
EJ
KD
vV
BI
vV
vV
sd
EJ
Da
Da
NQ
Da
Da
Da
Da
Da
Da
Da
Da
Da
Da
Da
Da
Da
Da
Da
Da
Hy
"}
(8,1,1) = {"
Hy
Da
Da
Da
Da
Da
EJ
vV
es
vV
es
vV
EJ
Id
vV
BI
vV
Mi
YU
EJ
Da
Da
NQ
Da
Da
Da
Da
Da
Da
Da
Da
Da
Da
Da
Da
Da
Da
Da
Da
Hy
"}
(9,1,1) = {"
Hy
Da
Da
Da
Da
Da
EJ
vV
es
vV
es
TT
EJ
vV
Zs
BI
JI
vV
vV
EJ
Da
Da
NQ
Da
Da
Da
Da
Da
Da
Da
Da
Da
Da
Da
Da
Da
Da
Da
Da
Hy
"}
(10,1,1) = {"
Hy
Da
Da
Da
Da
Da
EJ
zF
jf
jf
Tj
vV
EJ
aM
QF
BI
om
YU
kh
EJ
Da
Da
NQ
Da
Da
Da
Da
Da
Da
Da
Da
Da
Da
Da
Da
Da
Da
Da
Da
Hy
"}
(11,1,1) = {"
Hy
Da
Da
Da
Da
Da
EJ
es
EJ
EJ
EJ
rL
EJ
EJ
EJ
AJ
EJ
EJ
EJ
EJ
EJ
EJ
EJ
EJ
Da
Da
Da
Da
Da
Da
Da
Da
Da
Da
Da
Da
Da
Da
Da
Hy
"}
(12,1,1) = {"
Hy
Da
Da
Da
Da
Da
EJ
es
Vt
JI
rG
Xd
EJ
Mz
AH
yU
Mz
Mz
iK
VR
Kr
Kr
Kr
EJ
Da
Da
Da
OK
Da
Da
Da
Da
Da
Da
Da
Da
Da
Da
Da
Hy
"}
(13,1,1) = {"
Hy
Da
Da
Da
Da
Da
EJ
es
Vt
qS
Ic
zP
uF
pb
pb
Fw
Mz
rJ
rJ
VR
ob
IB
Kr
EJ
Da
Da
Da
Da
Da
Da
Da
Da
Da
Da
Da
Da
Da
Da
Da
Hy
"}
(14,1,1) = {"
Hy
Da
Da
Da
Da
Da
EJ
es
EJ
vV
lK
vV
At
Mz
Mz
Mz
Mz
Mz
Mz
Ry
Kr
IB
IB
EJ
Da
Da
Da
Da
Hx
Da
Da
Da
Da
Da
pd
Da
Da
Da
Da
Hy
"}
(15,1,1) = {"
Hy
Da
Da
Da
Da
Da
EJ
es
Vt
JI
RB
lK
EJ
Cp
Mz
Mz
Mz
Mz
Mz
EJ
IB
IB
rJ
EJ
Da
Da
yS
Da
Da
Da
Da
pd
Da
Da
Da
Da
Da
Da
Da
Hy
"}
(16,1,1) = {"
Hy
Da
Da
Da
Da
Da
EJ
es
Vt
oJ
YU
vV
EJ
BG
Cp
Mz
Tt
OU
OU
EJ
Kr
IB
rJ
EJ
pd
Hx
Da
Da
Da
CY
Da
Da
Da
Da
Da
Da
Da
Da
Da
Hy
"}
(17,1,1) = {"
Hy
Da
Da
Da
Da
Da
EJ
bb
EJ
EJ
EJ
Xn
EJ
EJ
EJ
Ry
EJ
EJ
EJ
EJ
Kr
IB
OK
Da
Da
Da
NQ
pd
Da
Da
Da
Da
Da
Da
Da
Da
Da
Da
Da
Hy
"}
(18,1,1) = {"
Hy
Da
Da
Da
Da
Da
Zt
fY
Uq
Uq
oO
oO
Uq
WL
Uq
Uq
Uq
Uq
WL
XZ
IB
Da
OK
OK
Da
Da
NQ
VH
Da
Da
Da
Da
OK
Da
Da
pd
Da
Da
Da
Hy
"}
(19,1,1) = {"
Hy
Da
Da
Da
Da
Da
Da
rJ
rJ
rJ
oO
rJ
oO
rJ
oO
oO
Hx
NQ
Uq
oO
NQ
NQ
Da
OK
qA
Da
NQ
zt
Da
OK
Da
Da
Da
Da
Da
Da
Da
Da
Da
Hy
"}
(20,1,1) = {"
Hy
Da
Da
Da
Da
Da
Da
He
bk
nV
oO
nV
oO
oO
Da
NQ
Da
NQ
Da
Da
yS
Hx
Da
Da
Da
Da
NQ
NQ
Da
Da
Da
pd
Da
Da
Da
Da
Da
Da
Da
Hy
"}
(21,1,1) = {"
Hy
Da
Da
Da
Da
NQ
bk
Da
hm
rJ
hm
hm
NQ
oO
Da
Da
Da
Da
OK
Da
Da
OK
OK
Da
Da
NQ
Da
Da
Da
Da
Da
Da
Da
Da
Da
Da
NQ
Da
Da
Hy
"}
(22,1,1) = {"
Hy
Hx
Da
Da
Da
Da
bk
Da
Da
VH
Da
VH
VH
NQ
Hx
Da
Da
Da
Da
Da
Da
Da
Da
Da
Hx
pd
Da
Da
Da
yS
Da
Da
Da
Da
OK
Da
Da
Da
Da
Hy
"}
(23,1,1) = {"
Hy
Da
Da
Da
Da
NQ
bk
Zt
Zt
Da
Da
Da
Da
Da
pd
Da
Da
oO
Uq
Uq
Da
NQ
Da
Da
Da
Da
Da
Da
Hx
Da
pd
NQ
Da
Da
Da
Da
Da
Da
Da
Hy
"}
(24,1,1) = {"
Hy
Da
Da
NQ
Da
Da
Da
NQ
Da
Da
Hx
OK
Da
Da
fq
NQ
FO
FO
FO
FO
Da
bk
Hx
Da
Da
Da
YT
Ec
Da
Da
Da
Da
Da
Da
NQ
Da
Da
Da
Da
Hy
"}
(25,1,1) = {"
Hy
Da
Da
Da
Da
Hx
Da
Da
Da
Da
Da
Da
zo
OK
Da
VH
NQ
NQ
TM
NQ
NQ
Da
Da
pd
NQ
NQ
OA
VH
Da
OK
Da
Hx
Da
Da
pd
Da
Da
Da
Da
Hy
"}
(26,1,1) = {"
Hy
Da
Da
Da
NQ
Da
Da
Da
Da
Da
Da
Da
Da
Da
Da
Da
Da
Da
Da
NQ
NQ
Da
Da
Da
Da
Da
VH
VH
Da
Da
Da
Hx
Da
Da
Da
Da
Da
Da
Da
Hy
"}
(27,1,1) = {"
Hy
Hx
Da
Da
Da
Da
ub
Hx
Hx
Da
pd
Da
Da
Da
Da
Da
Da
Da
Da
Da
Da
Da
OK
Da
Hx
Da
yS
Da
Da
OK
Da
Da
Da
Da
Da
Da
Da
Da
Da
Hy
"}
(28,1,1) = {"
Hy
Da
Da
Da
Da
Da
Da
Da
Da
Da
Da
Da
Da
Da
NQ
OK
Da
Da
uA
Da
yS
Da
Da
Da
Hx
Da
Da
Da
Da
Da
Da
uA
Da
Da
Da
Da
Da
Da
yS
Hy
"}
(29,1,1) = {"
Hy
Da
Da
Hx
Da
Da
Da
Da
Hx
Da
Da
Da
CY
Da
Da
Hx
Da
Da
Da
Da
Da
Da
Da
OK
Hx
Da
mu
Da
Da
Da
Da
Da
Da
Da
Da
Da
pd
Da
Da
Hy
"}
(30,1,1) = {"
Hy
Da
Da
Da
Da
Da
Da
Da
Da
Da
Da
Hx
Hx
Da
Da
Da
Da
Da
NQ
Da
OK
Da
Da
UC
Da
Da
Da
Da
Hx
pd
Da
Da
Da
Da
Da
Da
Da
Da
Da
Hy
"}
(31,1,1) = {"
Hy
Da
pd
Da
Da
NQ
Da
Da
Da
NQ
Da
Hx
Da
Da
Da
Da
Da
Da
Da
Da
Da
NQ
Da
Da
Hx
Da
Da
uA
Da
Da
Da
Da
Da
Da
Da
Da
Da
Da
Da
Hy
"}
(32,1,1) = {"
Hy
Da
Da
Da
Da
Da
Da
Da
Da
Da
Da
Da
pd
Da
Da
Da
Da
mu
Da
Da
pd
Da
Da
NQ
Da
Da
Da
Da
Da
Da
Da
Da
CY
Da
Da
Da
Da
Da
Da
Hy
"}
(33,1,1) = {"
Hy
Da
Da
Hx
Da
Hx
Da
pd
Da
Da
Da
Da
Da
yS
Da
Da
Da
Da
Da
Da
Da
Da
Da
NQ
pd
Da
Da
Hx
Da
pd
Da
Da
Da
Da
Da
Da
Da
Da
Da
Hy
"}
(34,1,1) = {"
Hy
Da
Da
Da
Da
Da
Da
Da
Da
Hx
Da
Da
Da
Hx
Da
pd
Da
Hx
Da
Da
Da
Hx
Da
Da
OK
Da
Da
Da
Da
Da
Da
Da
Da
Da
Da
Da
Da
Da
Da
Hy
"}
(35,1,1) = {"
Hy
Da
Da
Da
Da
Da
Da
NQ
Da
Da
Da
Hx
Hx
Da
Da
Da
Da
Da
Da
Da
Da
Da
Da
NQ
Da
Da
Da
Da
Da
Da
Da
Da
Da
pd
Da
Da
Da
Da
Da
Hy
"}
(36,1,1) = {"
Hy
Da
Da
Da
Da
Da
Da
Da
Da
Da
Da
Da
Da
Da
Da
Da
Da
Da
Da
Da
Hx
Da
Da
Da
Da
pd
Da
Da
Da
Da
Da
Da
Da
Da
Da
Da
Da
Da
Da
Hy
"}
(37,1,1) = {"
Hy
Da
Da
Da
Da
Da
Da
Da
Da
Da
Da
Da
Da
Da
Da
Da
Da
Da
Da
Da
Da
CY
Da
Da
Da
Da
Da
Da
Da
Da
Da
Da
Da
Da
Da
Da
Da
Da
Da
Hy
"}
(38,1,1) = {"
Hy
Da
Da
Da
Da
Da
Da
Da
Da
Da
Da
Da
Da
Da
Da
Da
Da
Da
Da
Da
Da
Da
Da
Da
Da
Da
Da
Da
Da
Da
Da
Da
Da
Da
Da
Da
Da
Da
Da
Hy
"}
(39,1,1) = {"
Hy
Da
Da
Da
Da
Da
Da
Da
Da
Da
Da
Da
Da
Da
Da
Da
Da
Da
Da
yS
Da
Da
Da
Da
pd
Da
Da
Da
Da
Da
Da
Da
Da
Da
Da
Da
Da
Da
Da
Hy
"}
(40,1,1) = {"
Hy
Hy
Hy
Hy
Hy
Hy
Hy
Hy
Hy
Hy
Hy
Hy
Hy
Hy
Hy
Hy
Hy
Hy
Hy
Hy
Hy
Hy
Hy
Hy
Hy
Hy
Hy
Hy
Hy
Hy
Hy
Hy
Hy
Hy
Hy
Hy
Hy
Hy
Hy
Hy
"}
