//MAP CONVERTED BY dmm2tgm.py THIS HEADER COMMENT PREVENTS RECONVERSION, DO NOT REMOVE
"a" = (
/obj/structure/shuttle/engine/propulsion{
	dir = 8;
	tag = "icon-propulsion (EAST)"
	},
/turf/simulated/floor/shuttle/plating,
/area/shuttle/transport)
"l" = (
/turf/simulated/floor/noslip{
	icon = 'icons/turf/shuttle/floors.dmi';
	icon_state = "floor"
	},
/area/shuttle/transport)
"m" = (
/obj/structure/chair/comfy/shuttle{
	dir = 1
	},
/turf/simulated/floor/noslip{
	icon = 'icons/turf/shuttle/floors.dmi';
	icon_state = "floor"
	},
/area/shuttle/transport)
"u" = (
/obj/structure/window/full/shuttle,
/obj/structure/grille,
/turf/simulated/floor/shuttle/plating,
/area/shuttle/transport)
"D" = (
/obj/structure/window/full/shuttle{
	dir = 4;
	icon = 'icons/turf/shuttle.dmi';
	icon_state = "window5_end";
	layer = 6;
	tag = "icon-window5_end (EAST)"
	},
/obj/machinery/door/window/survival_pod{
	dir = 1;
	layer = 3;
	req_access_txt = "104;106;63;19"
	},
/turf/simulated/floor{
	dir = 1;
	icon_state = "darkgreycamo"
	},
/area/shuttle/transport)
"F" = (
/obj/machinery/door/airlock/shuttle{
	id_tag = "s_docking_airlock";
	req_access_txt = "31;105;63"
	},
/obj/docking_port/mobile{
	dir = 8;
	dwidth = 2;
	height = 12;
	id = "ferry";
	name = "ferry shuttle";
	roundstart_move = "ferry_away";
	timid = 1;
	width = 5
	},
/obj/structure/fans/tiny,
/turf/simulated/floor/noslip{
	icon = 'icons/turf/shuttle/floors.dmi';
	icon_state = "floor"
	},
/area/shuttle/transport)
"G" = (
/turf/simulated/wall/shuttle{
	icon_state = "shuttle"
	},
/area/shuttle/transport)
"H" = (
/obj/structure/chair/comfy/shuttle,
/turf/simulated/floor/noslip{
	icon = 'icons/turf/shuttle/floors.dmi';
	icon_state = "floor"
	},
/area/shuttle/transport)
"J" = (
/obj/machinery/computer/shuttle/ferry/request{
	dir = 8
	},
/turf/simulated/floor/noslip{
	icon = 'icons/turf/shuttle/floors.dmi';
	icon_state = "floor"
	},
/area/shuttle/transport)
"L" = (
/obj/machinery/door/airlock/shuttle{
	id_tag = "s_docking_airlock";
	req_access_txt = "31;105;63"
	},
/obj/structure/fans/tiny,
/turf/simulated/floor/noslip{
	icon = 'icons/turf/shuttle/floors.dmi';
	icon_state = "floor"
	},
/area/shuttle/transport)
"M" = (
/obj/structure/shuttle/engine/propulsion{
	dir = 8;
	tag = "icon-propulsion (EAST)"
	},
/turf/space,
/area/shuttle/transport)
"O" = (
/obj/structure/table/reinforced,
/obj/machinery/recharger,
/turf/simulated/floor/noslip{
	icon = 'icons/turf/shuttle/floors.dmi';
	icon_state = "floor"
	},
/area/shuttle/transport)
"P" = (
/obj/structure/closet/crate/freezer,
/obj/item/grenade/clusterbuster/meat,
/obj/item/reagent_containers/food/snacks/meat,
/obj/item/reagent_containers/food/snacks/meat,
/obj/item/reagent_containers/food/snacks/meat,
/obj/item/reagent_containers/food/snacks/meat,
/obj/item/reagent_containers/food/snacks/meat,
/obj/machinery/light/spot{
	dir = 1;
	icon_state = "tube1";
	tag = "icon-tube1 (NORTH)"
	},
/turf/simulated/floor/noslip{
	icon = 'icons/turf/shuttle/floors.dmi';
	icon_state = "floor"
	},
/area/shuttle/transport)
"R" = (
/obj/structure/closet/crate/freezer,
/obj/item/reagent_containers/food/snacks/grown/pineapple,
/obj/item/reagent_containers/food/snacks/grown/pineapple,
/obj/item/reagent_containers/food/snacks/grown/redbeet,
/obj/item/reagent_containers/food/snacks/grown/redbeet,
/obj/item/reagent_containers/food/snacks/grown/redbeet,
/obj/item/reagent_containers/food/snacks/grown/sugarcane,
/obj/item/reagent_containers/food/snacks/grown/sugarcane,
/obj/item/reagent_containers/food/snacks/grown/sugarcane,
/obj/item/reagent_containers/food/snacks/grown/banana,
/obj/item/reagent_containers/food/snacks/grown/banana,
/obj/item/reagent_containers/food/snacks/grown/banana,
/obj/item/reagent_containers/food/snacks/grown/banana,
/obj/machinery/light/spot,
/turf/simulated/floor/noslip{
	icon = 'icons/turf/shuttle/floors.dmi';
	icon_state = "floor"
	},
/area/shuttle/transport)
"T" = (
/turf/simulated/wall/shuttle{
	icon_state = "shuttle"
	},
/area/shuttle/transport)
"W" = (
/turf/simulated/wall/shuttle{
	icon_state = "shuttle"
	},
/area/shuttle/transport)
"Z" = (
/obj/machinery/door/window/survival_pod{
	dir = 2;
	layer = 3;
	req_access_txt = "104;106;63;19"
	},
/obj/structure/window/full/shuttle{
	dir = 8;
	icon = 'icons/turf/shuttle.dmi';
	icon_state = "window5_end";
	layer = 6;
	tag = "icon-window5_end (WEST)"
	},
/turf/simulated/floor{
	icon_state = "darkgreycamo"
	},
/area/shuttle/transport)

(1,1,1) = {"
a
M
L
M
a
"}
(2,1,1) = {"
T
Z
l
D
T
"}
(3,1,1) = {"
T
Z
l
D
T
"}
(4,1,1) = {"
T
Z
l
D
T
"}
(5,1,1) = {"
T
Z
l
D
T
"}
(6,1,1) = {"
T
Z
l
D
T
"}
(7,1,1) = {"
T
Z
l
D
T
"}
(8,1,1) = {"
T
Z
l
D
T
"}
(9,1,1) = {"
T
P
l
R
T
"}
(10,1,1) = {"
T
H
l
m
T
"}
(11,1,1) = {"
T
O
l
J
T
"}
(12,1,1) = {"
G
u
F
u
W
"}
