//MAP CONVERTED BY dmm2tgm.py THIS HEADER COMMENT PREVENTS RECONVERSION, DO NOT REMOVE
"a" = (
/obj/structure/shuttle/engine/propulsion{
	dir = 8;
	tag = "icon-propulsion (EAST)"
	},
/turf/simulated/floor/shuttle/plating,
/area/shuttle/transport)
"b" = (
/obj/machinery/door/window/survival_pod{
	dir = 1;
	layer = 3;
	req_access = list(104,106,63,19)
	},
/obj/structure/window/plasmareinforced{
	dir = 8;
	layer = 2.9
	},
/turf/simulated/floor{
	dir = 1;
	icon_state = "darkgreycamo"
	},
/area/shuttle/transport)
"j" = (
/turf/simulated/wall/shuttle{
	icon = 'icons/turf/walls/shuttle/gray_shuttle_wall.dmi'
	},
/area/shuttle/transport)
"k" = (
/obj/item/restraints/handcuffs/pinkcuffs{
	pixel_y = 10;
	pixel_x = 5
	},
/obj/structure/mirror{
	pixel_y = 26
	},
/turf/simulated/floor/shuttle/syndicate,
/area/shuttle/transport)
"l" = (
/obj/structure/kitchenspike,
/obj/machinery/light/small,
/turf/simulated/floor/shuttle/syndicate,
/area/shuttle/transport)
"m" = (
/obj/docking_port/mobile{
	dir = 8;
	dwidth = 2;
	height = 12;
	id = "ferry";
	name = "ferry shuttle";
	roundstart_move = "ferry_away";
	timid = 1;
	width = 5
	},
/obj/structure/fans/tiny,
/obj/machinery/door/airlock/hatch{
	id_tag = "s_docking_airlock";
	name = "shuttle airlock"
	},
/turf/simulated/floor/shuttle/syndicate,
/area/shuttle/transport)
"p" = (
/turf/simulated/floor/shuttle/syndicate,
/area/shuttle/transport)
"s" = (
/obj/item/reagent_containers/food/drinks/bottle/vodka/badminka{
	pixel_x = 8;
	pixel_y = 7
	},
/obj/item/reagent_containers/syringe/bioterror{
	pixel_x = -5;
	pixel_y = -3
	},
/obj/item/reagent_containers/syringe/capulettium_plus{
	pixel_x = -5
	},
/obj/item/reagent_containers/syringe/gluttony{
	pixel_x = -5;
	pixel_y = 3
	},
/obj/item/reagent_containers/syringe/lethal{
	pixel_x = -5;
	pixel_y = 6
	},
/obj/item/reagent_containers/syringe/pancuronium{
	pixel_x = -5;
	pixel_y = 9
	},
/obj/item/reagent_containers/syringe/sarin{
	pixel_x = -5;
	pixel_y = 12
	},
/obj/item/reagent_containers/glass/bottle/mutagen{
	pixel_y = 6
	},
/obj/structure/table/reinforced,
/turf/simulated/floor/shuttle/syndicate,
/area/shuttle/transport)
"u" = (
/obj/effect/spawner/random_spawners/oil_20,
/turf/simulated/floor/shuttle/syndicate,
/area/shuttle/transport)
"y" = (
/obj/structure/fans/tiny,
/obj/machinery/door/airlock/hatch{
	id_tag = "s_docking_airlock";
	name = "shuttle airlock"
	},
/turf/simulated/floor/shuttle/syndicate,
/area/shuttle/transport)
"A" = (
/obj/item/soap/ducttape,
/obj/item/clothing/mask/muzzle{
	pixel_y = 8
	},
/turf/simulated/floor/shuttle/syndicate,
/area/shuttle/transport)
"B" = (
/obj/structure/grille,
/obj/structure/window/full/shuttle/gray,
/turf/simulated/floor/shuttle/plating,
/area/shuttle/transport)
"C" = (
/obj/machinery/light/small,
/obj/item/assembly/mousetrap{
	pixel_x = -6;
	pixel_y = 1
	},
/obj/item/assembly/mousetrap{
	pixel_x = 8;
	pixel_y = 7
	},
/obj/structure/kitchenspike,
/turf/simulated/floor/shuttle/syndicate,
/area/shuttle/transport)
"D" = (
/obj/structure/dresser,
/turf/simulated/floor/shuttle/syndicate,
/area/shuttle/transport)
"F" = (
/obj/item/clothing/mask/muzzle{
	pixel_y = 8
	},
/turf/simulated/floor/shuttle/syndicate,
/area/shuttle/transport)
"G" = (
/obj/structure/table/reinforced,
/obj/item/radio/electropack,
/obj/item/assembly/signaler{
	code = 2;
	frequency = 1449;
	pixel_x = 8
	},
/obj/item/radio/electropack,
/obj/item/assembly/signaler{
	code = 2;
	frequency = 1449;
	pixel_x = 8
	},
/obj/structure/window/reinforced/survival_pod{
	dir = 8
	},
/turf/simulated/floor/shuttle/syndicate,
/area/shuttle/transport)
"H" = (
/obj/machinery/vending/boozeomat,
/turf/simulated/floor/shuttle/syndicate,
/area/shuttle/transport)
"I" = (
/obj/item/soap,
/obj/structure/mirror{
	pixel_y = 26
	},
/turf/simulated/floor/shuttle/syndicate,
/area/shuttle/transport)
"J" = (
/obj/item/restraints/handcuffs/pinkcuffs,
/turf/simulated/floor/shuttle/syndicate,
/area/shuttle/transport)
"L" = (
/obj/machinery/disco{
	anchored = 1
	},
/turf/simulated/floor/shuttle/syndicate,
/area/shuttle/transport)
"N" = (
/obj/structure/chair/comfy/black{
	dir = 8
	},
/turf/simulated/floor/shuttle/syndicate,
/area/shuttle/transport)
"O" = (
/obj/structure/closet/cabinet,
/obj/item/clothing/shoes/jackboots,
/obj/item/clothing/shoes/jackboots,
/obj/item/clothing/shoes/jackboots,
/obj/item/clothing/suit/jacket/leather/overcoat,
/obj/item/clothing/suit/jacket/leather/overcoat,
/obj/item/clothing/suit/jacket/leather/overcoat,
/obj/item/clothing/head/soft/sec/corp,
/obj/item/clothing/head/soft/sec/corp,
/obj/item/clothing/head/soft/sec/corp,
/obj/item/clothing/mask/face/jackal,
/obj/item/clothing/mask/face/jackal,
/obj/item/clothing/mask/face/jackal,
/obj/item/clothing/mask/face/raven,
/obj/item/clothing/mask/face/raven,
/obj/item/clothing/mask/face/raven,
/turf/simulated/floor/shuttle/syndicate,
/area/shuttle/transport)
"P" = (
/obj/effect/spawner/random_spawners/blood_20,
/turf/simulated/floor/shuttle/syndicate,
/area/shuttle/transport)
"S" = (
/obj/machinery/computer/shuttle/ferry/request{
	dir = 4
	},
/obj/structure/window/plasmareinforced{
	dir = 8;
	layer = 2.9
	},
/turf/simulated/floor/shuttle/syndicate,
/area/shuttle/transport)
"U" = (
/obj/structure/chair/comfy/black,
/obj/item/clothing/mask/muzzle{
	pixel_y = 8
	},
/turf/simulated/floor/shuttle/syndicate,
/area/shuttle/transport)
"Z" = (
/obj/structure/chair/comfy/black{
	dir = 1
	},
/turf/simulated/floor/shuttle/syndicate,
/area/shuttle/transport)

(1,1,1) = {"
a
a
y
a
a
"}
(2,1,1) = {"
j
S
p
b
j
"}
(3,1,1) = {"
j
N
F
G
j
"}
(4,1,1) = {"
j
k
P
Z
j
"}
(5,1,1) = {"
j
O
p
C
j
"}
(6,1,1) = {"
j
D
p
u
j
"}
(7,1,1) = {"
j
O
J
L
j
"}
(8,1,1) = {"
j
I
u
P
j
"}
(9,1,1) = {"
j
U
p
l
j
"}
(10,1,1) = {"
j
H
p
Z
j
"}
(11,1,1) = {"
j
s
A
u
j
"}
(12,1,1) = {"
j
B
m
B
j
"}
