//MAP CONVERTED BY dmm2tgm.py THIS HEADER COMMENT PREVENTS RECONVERSION, DO NOT REMOVE
"a" = (
/turf/simulated/wall/shuttle,
/area/shuttle/transport)
"d" = (
/obj/machinery/power/rad_collector,
/obj/machinery/atmospherics/pipe/simple/visible{
	dir = 9
	},
/obj/structure/cable/yellow,
/turf/simulated/floor/plasteel{
	dir = 7;
	icon_state = "yellow"
	},
/area/shuttle/transport)
"e" = (
/obj/structure/window/plasmareinforced{
	dir = 1
	},
/obj/machinery/atmospherics/unary/vent_pump/on{
	dir = 4
	},
/turf/simulated/floor/engine,
/area/shuttle/transport)
"g" = (
/obj/structure/cable/yellow{
	d1 = 4;
	d2 = 8;
	icon_state = "4-8"
	},
/obj/machinery/atmospherics/pipe/manifold/visible{
	dir = 1
	},
/turf/simulated/floor/plasteel,
/area/shuttle/transport)
"h" = (
/obj/structure/window/plasmareinforced{
	dir = 8;
	layer = 2.9
	},
/obj/machinery/power/rad_collector,
/obj/machinery/atmospherics/pipe/simple/visible{
	dir = 4
	},
/obj/structure/cable/yellow{
	d2 = 2;
	icon_state = "0-2"
	},
/turf/simulated/floor/plasteel{
	dir = 9;
	icon_state = "yellow"
	},
/area/shuttle/transport)
"i" = (
/obj/structure/shuttle/engine/propulsion{
	dir = 8;
	tag = "icon-propulsion (EAST)"
	},
/obj/structure/window/plasmareinforced{
	dir = 4
	},
/turf/simulated/floor/shuttle/plating,
/area/shuttle/transport)
"j" = (
/obj/structure/cable/yellow{
	d1 = 4;
	d2 = 8;
	icon_state = "4-8"
	},
/obj/machinery/atmospherics/pipe/simple/visible,
/obj/machinery/atmospherics/pipe/simple/visible{
	dir = 4
	},
/turf/simulated/floor/plasteel,
/area/shuttle/transport)
"k" = (
/obj/structure/closet/radiation,
/obj/item/clothing/glasses/meson,
/obj/machinery/atmospherics/pipe/manifold/visible{
	dir = 1
	},
/turf/simulated/floor/plasteel{
	dir = 1;
	icon_state = "yellow"
	},
/area/shuttle/transport)
"m" = (
/obj/docking_port/mobile{
	dir = 8;
	dwidth = 2;
	height = 12;
	id = "ferry";
	name = "ferry shuttle";
	roundstart_move = "ferry_away";
	timid = 1;
	width = 5
	},
/obj/structure/fans/tiny,
/obj/machinery/door/airlock/shuttle{
	id_tag = "s_docking_airlock";
	req_access = list(32,101,19)
	},
/obj/structure/cable/yellow{
	d1 = 4;
	d2 = 8;
	icon_state = "4-8"
	},
/turf/simulated/floor/plasteel,
/area/shuttle/transport)
"n" = (
/obj/machinery/atmospherics/pipe/manifold/visible{
	dir = 1
	},
/obj/structure/cable/yellow{
	d1 = 4;
	d2 = 8;
	icon_state = "4-8"
	},
/obj/machinery/alarm{
	pixel_y = 55
	},
/turf/simulated/floor/plasteel,
/area/shuttle/transport)
"p" = (
/obj/machinery/atmospherics/pipe/simple/visible{
	dir = 4
	},
/obj/structure/dispenser,
/turf/simulated/floor/plasteel{
	dir = 1;
	icon_state = "yellow"
	},
/area/shuttle/transport)
"s" = (
/obj/structure/window/plasmareinforced{
	dir = 8;
	layer = 2.9
	},
/obj/machinery/power/rad_collector,
/obj/machinery/atmospherics/pipe/simple/visible{
	dir = 4
	},
/obj/structure/cable/yellow,
/turf/simulated/floor/plasteel{
	dir = 10;
	icon_state = "yellow"
	},
/area/shuttle/transport)
"t" = (
/obj/structure/cable/yellow{
	d1 = 4;
	d2 = 8;
	icon_state = "4-8"
	},
/obj/machinery/atmospherics/pipe/simple/visible{
	dir = 10
	},
/turf/simulated/floor/plasteel,
/area/shuttle/transport)
"u" = (
/obj/machinery/atmospherics/unary/portables_connector{
	dir = 1
	},
/obj/machinery/portable_atmospherics/canister,
/turf/simulated/floor/plasteel{
	dir = 6;
	icon_state = "yellow"
	},
/area/shuttle/transport)
"w" = (
/obj/machinery/atmospherics/pipe/simple/visible{
	dir = 9
	},
/obj/machinery/light,
/obj/machinery/portable_atmospherics/canister/toxins,
/turf/simulated/floor/plasteel{
	dir = 7;
	icon_state = "yellow"
	},
/area/shuttle/transport)
"x" = (
/obj/machinery/power/supermatter_shard{
	anchored = 1
	},
/turf/simulated/floor/engine,
/area/shuttle/transport)
"z" = (
/obj/machinery/power/rad_collector,
/obj/machinery/atmospherics/pipe/simple/visible{
	dir = 4
	},
/obj/structure/cable/yellow{
	d2 = 2;
	icon_state = "0-2"
	},
/turf/simulated/floor/plasteel{
	dir = 1;
	icon_state = "yellow"
	},
/area/shuttle/transport)
"B" = (
/obj/machinery/atmospherics/pipe/simple/visible{
	dir = 5
	},
/obj/machinery/portable_atmospherics/canister/toxins,
/turf/simulated/floor/plasteel{
	dir = 7;
	icon_state = "yellow"
	},
/area/shuttle/transport)
"C" = (
/obj/machinery/atmospherics/unary/cold_sink/freezer{
	current_temperature = 0;
	dir = 1;
	on = 1
	},
/turf/simulated/floor/plasteel{
	dir = 7;
	icon_state = "yellow"
	},
/area/shuttle/transport)
"D" = (
/obj/machinery/atmospherics/unary/portables_connector{
	dir = 8
	},
/turf/simulated/floor/plasteel{
	dir = 5;
	icon_state = "yellow"
	},
/area/shuttle/transport)
"G" = (
/obj/structure/cable/yellow{
	d1 = 4;
	d2 = 8;
	icon_state = "4-8"
	},
/obj/machinery/atmospherics/trinary/filter{
	dir = 4;
	filter_type = "n2";
	name = "nitrogen filter";
	on = 1
	},
/turf/simulated/floor/plasteel,
/area/shuttle/transport)
"H" = (
/obj/machinery/atmospherics/pipe/manifold/visible{
	dir = 1
	},
/obj/structure/cable/yellow{
	d1 = 4;
	d2 = 8;
	icon_state = "4-8"
	},
/turf/simulated/floor/plasteel,
/area/shuttle/transport)
"J" = (
/obj/machinery/atmospherics/pipe/simple/visible{
	dir = 4
	},
/obj/machinery/computer/shuttle/ferry/request,
/turf/simulated/floor/plasteel{
	dir = 1;
	icon_state = "yellow"
	},
/area/shuttle/transport)
"L" = (
/obj/machinery/atmospherics/pipe/simple/visible{
	dir = 4
	},
/obj/structure/cable/yellow,
/obj/machinery/light,
/turf/simulated/floor/plasteel{
	dir = 7;
	icon_state = "yellow"
	},
/area/shuttle/transport)
"M" = (
/obj/machinery/atmospherics/unary/vent_scrubber/on{
	dir = 4
	},
/turf/simulated/floor/engine,
/area/shuttle/transport)
"N" = (
/obj/structure/window/plasmareinforced{
	dir = 1
	},
/turf/simulated/wall/shuttle,
/area/shuttle/transport)
"O" = (
/obj/machinery/atmospherics/pipe/simple/visible{
	dir = 4
	},
/obj/structure/cable/yellow{
	d2 = 2;
	icon_state = "0-2"
	},
/turf/simulated/floor/plasteel{
	dir = 1;
	icon_state = "yellow"
	},
/area/shuttle/transport)
"P" = (
/obj/machinery/atmospherics/pipe/simple/visible{
	dir = 4
	},
/obj/machinery/computer/sm_monitor,
/turf/simulated/floor/plasteel{
	dir = 1;
	icon_state = "yellow"
	},
/area/shuttle/transport)
"Q" = (
/obj/structure/window/full/shuttle,
/obj/structure/grille,
/turf/simulated/floor/shuttle/plating,
/area/shuttle/transport)
"R" = (
/obj/structure/window/plasmareinforced{
	dir = 8;
	layer = 2.9
	},
/obj/machinery/power/grounding_rod{
	pixel_x = -44;
	anchored = 1
	},
/obj/structure/cable/yellow{
	d1 = 2;
	d2 = 4;
	icon_state = "2-4"
	},
/obj/structure/cable/yellow{
	d1 = 1;
	d2 = 4;
	icon_state = "1-4"
	},
/obj/machinery/power/emitter{
	dir = 8;
	anchored = 1
	},
/obj/structure/cable/yellow{
	d2 = 4;
	icon_state = "0-4"
	},
/turf/simulated/floor/plasteel{
	dir = 8;
	icon_state = "yellow"
	},
/area/shuttle/transport)
"V" = (
/obj/machinery/atmospherics/pipe/simple/visible{
	dir = 4
	},
/obj/machinery/portable_atmospherics/canister/toxins,
/turf/simulated/floor/plasteel{
	dir = 1;
	icon_state = "yellow"
	},
/area/shuttle/transport)
"W" = (
/obj/structure/shuttle/engine/propulsion{
	dir = 8;
	tag = "icon-propulsion (EAST)"
	},
/turf/simulated/floor/shuttle/plating,
/area/shuttle/transport)
"Y" = (
/obj/machinery/atmospherics/pipe/simple/visible{
	dir = 6
	},
/obj/structure/cable/yellow{
	d1 = 2;
	d2 = 4;
	icon_state = "2-4"
	},
/obj/structure/cable/yellow{
	d1 = 1;
	d2 = 4;
	icon_state = "1-4"
	},
/obj/structure/cable/yellow{
	d1 = 4;
	d2 = 8;
	icon_state = "4-8"
	},
/turf/simulated/floor/plasteel,
/area/shuttle/transport)
"Z" = (
/obj/structure/cable/yellow{
	d1 = 2;
	d2 = 4;
	icon_state = "2-4"
	},
/obj/structure/cable/yellow{
	d1 = 1;
	d2 = 4;
	icon_state = "1-4"
	},
/obj/structure/cable/yellow{
	d1 = 4;
	d2 = 8;
	icon_state = "4-8"
	},
/turf/simulated/floor/plasteel,
/area/shuttle/transport)

(1,1,1) = {"
W
i
i
i
W
"}
(2,1,1) = {"
a
e
x
M
N
"}
(3,1,1) = {"
a
h
R
s
a
"}
(4,1,1) = {"
a
O
Z
L
a
"}
(5,1,1) = {"
a
z
Y
d
a
"}
(6,1,1) = {"
a
P
n
C
a
"}
(7,1,1) = {"
a
J
g
C
a
"}
(8,1,1) = {"
a
V
H
C
a
"}
(9,1,1) = {"
a
p
G
B
a
"}
(10,1,1) = {"
a
k
j
w
a
"}
(11,1,1) = {"
a
D
t
u
a
"}
(12,1,1) = {"
a
Q
m
Q
a
"}
