//MAP CONVERTED BY dmm2tgm.py THIS HEADER COMMENT PREVENTS RECONVERSION, DO NOT REMOVE
"a" = (
/obj/structure/shuttle/engine/propulsion{
	dir = 8;
	tag = "icon-propulsion (EAST)"
	},
/turf/simulated/floor/shuttle/plating,
/area/shuttle/transport)
"e" = (
/obj/structure/table/reinforced,
/obj/machinery/door/window/brigdoor{
	req_access = list(33,103)
	},
/obj/structure/window/reinforced{
	pixel_y = -4
	},
/turf/simulated/floor/shuttle,
/area/shuttle/transport)
"h" = (
/obj/structure/window/full/shuttle,
/obj/structure/grille,
/turf/simulated/floor/shuttle/plating,
/area/shuttle/transport)
"n" = (
/obj/machinery/chem_heater,
/turf/simulated/floor/shuttle,
/area/shuttle/transport)
"p" = (
/obj/machinery/smartfridge/medbay{
	req_access = list(33,103)
	},
/obj/structure/window/reinforced,
/turf/simulated/floor/shuttle,
/area/shuttle/transport)
"q" = (
/obj/structure/window/plasmareinforced{
	dir = 8;
	layer = 2.9
	},
/obj/machinery/chem_heater,
/turf/simulated/floor/shuttle,
/area/shuttle/transport)
"r" = (
/obj/item/phone{
	attack_verb = list("bounced a check off","checked-out","tipped");
	desc = "Also known as a cash register, or, more commonly, \"robbery magnet\". It's old and rusty, clearly non-functional and decorative only.";
	icon = 'icons/obj/machines/pos.dmi';
	icon_state = "pos";
	name = "point of sale"
	},
/obj/structure/table/reinforced,
/obj/structure/window/reinforced{
	dir = 4
	},
/obj/machinery/light/spot{
	dir = 1;
	tag = "icon-tube1 (NORTH)"
	},
/turf/simulated/floor/shuttle,
/area/shuttle/transport)
"s" = (
/turf/simulated/wall/shuttle,
/area/shuttle/transport)
"t" = (
/obj/structure/closet/secure_closet/reagents,
/turf/simulated/floor/shuttle,
/area/shuttle/transport)
"u" = (
/obj/structure/sign/chemistry{
	pixel_y = 32
	},
/turf/simulated/floor/shuttle,
/area/shuttle/transport)
"v" = (
/obj/machinery/door/airlock/shuttle{
	id_tag = "s_docking_airlock"
	},
/obj/docking_port/mobile{
	dir = 8;
	dwidth = 2;
	height = 12;
	id = "ferry";
	name = "ferry shuttle";
	roundstart_move = "ferry_away";
	timid = 1;
	width = 5
	},
/obj/structure/fans/tiny,
/turf/simulated/floor/shuttle,
/area/shuttle/transport)
"y" = (
/obj/structure/closet/crate/medical,
/obj/item/reagent_containers/glass/beaker/large{
	pixel_x = -5;
	pixel_y = 1
	},
/obj/item/reagent_containers/glass/beaker/large{
	pixel_x = -5;
	pixel_y = 1
	},
/obj/item/reagent_containers/glass/beaker/large{
	pixel_x = -5;
	pixel_y = 1
	},
/obj/item/reagent_containers/glass/beaker/large{
	pixel_x = -5;
	pixel_y = 1
	},
/obj/item/reagent_containers/glass/beaker/large{
	pixel_x = -5;
	pixel_y = 1
	},
/obj/item/reagent_containers/glass/beaker/large{
	pixel_x = -5;
	pixel_y = 1
	},
/obj/item/reagent_containers/glass/beaker/large{
	pixel_x = -5;
	pixel_y = 1
	},
/obj/item/reagent_containers/glass/beaker/large{
	pixel_x = -5;
	pixel_y = 1
	},
/obj/item/storage/box/iv_bags{
	pixel_x = 4;
	pixel_y = 4
	},
/obj/item/storage/box/syringes,
/obj/machinery/light/spot,
/turf/simulated/floor/shuttle,
/area/shuttle/transport)
"C" = (
/obj/structure/chair/office/light{
	dir = 1
	},
/turf/simulated/floor/shuttle,
/area/shuttle/transport)
"D" = (
/obj/machinery/computer/shuttle/ferry/request,
/turf/simulated/floor/shuttle,
/area/shuttle/transport)
"F" = (
/obj/machinery/chem_dispenser,
/turf/simulated/floor/shuttle,
/area/shuttle/transport)
"J" = (
/turf/simulated/floor/shuttle,
/area/shuttle/transport)
"L" = (
/obj/machinery/door/airlock/shuttle{
	id_tag = "s_docking_airlock";
	req_access = list(33,103)
	},
/turf/simulated/floor/shuttle,
/area/shuttle/transport)
"N" = (
/obj/structure/window/plasmareinforced{
	dir = 8;
	layer = 2.9
	},
/turf/simulated/floor/shuttle,
/area/shuttle/transport)
"Q" = (
/obj/structure/reagent_dispensers/fueltank/chem{
	pixel_y = 30
	},
/obj/structure/closet/wardrobe/chemistry_white,
/obj/item/storage/bag/chemistry,
/obj/item/storage/bag/chemistry,
/turf/simulated/floor/shuttle,
/area/shuttle/transport)
"T" = (
/turf/simulated/wall/shuttle{
	tag = "icon-swall2"
	},
/area/shuttle/transport)
"W" = (
/obj/item/paper_bin,
/obj/item/lighter/zippo{
	name = "Ash Generator 3000"
	},
/obj/structure/table,
/obj/structure/window/plasmareinforced{
	dir = 8;
	layer = 2.9
	},
/turf/simulated/floor/shuttle,
/area/shuttle/transport)
"X" = (
/obj/machinery/chem_master,
/turf/simulated/floor/shuttle,
/area/shuttle/transport)
"Z" = (
/obj/structure/chair/office/light,
/turf/simulated/floor/shuttle,
/area/shuttle/transport)

(1,1,1) = {"
a
a
a
a
a
"}
(2,1,1) = {"
s
q
N
W
s
"}
(3,1,1) = {"
s
F
C
t
s
"}
(4,1,1) = {"
s
X
J
y
s
"}
(5,1,1) = {"
s
Q
J
X
s
"}
(6,1,1) = {"
s
D
Z
F
s
"}
(7,1,1) = {"
s
J
J
n
s
"}
(8,1,1) = {"
s
p
L
T
s
"}
(9,1,1) = {"
h
J
J
J
h
"}
(10,1,1) = {"
s
r
e
L
s
"}
(11,1,1) = {"
s
u
J
J
s
"}
(12,1,1) = {"
s
h
v
h
s
"}
