//MAP CONVERTED BY dmm2tgm.py THIS HEADER COMMENT PREVENTS RECONVERSION, DO NOT REMOVE
"a" = (
/obj/structure/shuttle/engine/propulsion{
	dir = 8;
	tag = "icon-propulsion (EAST)"
	},
/turf/simulated/floor/shuttle/plating,
/area/shuttle/transport)
"b" = (
/obj/machinery/door/window/survival_pod{
	dir = 2;
	layer = 3;
	req_access = list(104,106,63,19)
	},
/mob/living/simple_animal/pet/dog/corgi/narsie{
	faction = list("neutral")
	},
/obj/structure/window/reinforced/survival_pod/unhittable{
	dir = 8;
	pixel_x = -4;
	damage_deflection = 100
	},
/turf/simulated/floor{
	icon_state = "darkgreycamo"
	},
/area/shuttle/transport)
"i" = (
/obj/machinery/door/window/survival_pod{
	dir = 2;
	layer = 3;
	req_access = list(104,106,63,19)
	},
/mob/living/simple_animal/hulk/zilla,
/obj/structure/window/reinforced/survival_pod/unhittable{
	dir = 8;
	pixel_x = -4;
	damage_deflection = 100
	},
/turf/simulated/floor{
	icon_state = "darkgreycamo"
	},
/area/shuttle/transport)
"l" = (
/turf/simulated/floor/noslip{
	icon = 'icons/turf/shuttle/floors.dmi';
	icon_state = "floor"
	},
/area/shuttle/transport)
"m" = (
/obj/structure/chair/comfy/shuttle{
	dir = 1
	},
/turf/simulated/floor/noslip{
	icon = 'icons/turf/shuttle/floors.dmi';
	icon_state = "floor"
	},
/area/shuttle/transport)
"o" = (
/obj/machinery/door/window/survival_pod{
	dir = 1;
	layer = 3;
	req_access = list(104,106,63,19)
	},
/obj/structure/window/plasmareinforced{
	dir = 8;
	layer = 2.9
	},
/turf/simulated/floor{
	dir = 1;
	icon_state = "darkgreycamo"
	},
/area/shuttle/transport)
"u" = (
/obj/structure/window/full/shuttle,
/obj/structure/grille,
/turf/simulated/floor/shuttle/plating,
/area/shuttle/transport)
"w" = (
/obj/machinery/door/window/survival_pod{
	dir = 1;
	layer = 3;
	req_access = list(104,106,63,19)
	},
/mob/living/simple_animal/hostile/creature{
	faction = list("neutral")
	},
/obj/structure/window/reinforced/survival_pod/unhittable{
	dir = 8;
	pixel_x = -4;
	damage_deflection = 100
	},
/turf/simulated/floor{
	dir = 1;
	icon_state = "darkgreycamo"
	},
/area/shuttle/transport)
"D" = (
/obj/machinery/door/window/survival_pod{
	dir = 1;
	layer = 3;
	req_access = list(104,106,63,19)
	},
/mob/living/simple_animal/hostile/netherworld/migo{
	faction = list("neutral")
	},
/obj/structure/window/reinforced/survival_pod/unhittable{
	dir = 8;
	pixel_x = -4;
	damage_deflection = 100
	},
/turf/simulated/floor{
	dir = 1;
	icon_state = "darkgreycamo"
	},
/area/shuttle/transport)
"F" = (
/obj/machinery/door/airlock/shuttle{
	id_tag = "s_docking_airlock";
	req_access = list(31,105,63)
	},
/obj/docking_port/mobile{
	dir = 8;
	dwidth = 2;
	height = 12;
	id = "ferry";
	name = "ferry shuttle";
	roundstart_move = "ferry_away";
	timid = 1;
	width = 5
	},
/obj/structure/fans/tiny,
/turf/simulated/floor/noslip{
	icon = 'icons/turf/shuttle/floors.dmi';
	icon_state = "floor"
	},
/area/shuttle/transport)
"G" = (
/turf/simulated/wall/shuttle,
/area/shuttle/transport)
"H" = (
/obj/structure/chair/comfy/shuttle,
/turf/simulated/floor/noslip{
	icon = 'icons/turf/shuttle/floors.dmi';
	icon_state = "floor"
	},
/area/shuttle/transport)
"J" = (
/obj/machinery/computer/shuttle/ferry/request{
	dir = 8
	},
/turf/simulated/floor/noslip{
	icon = 'icons/turf/shuttle/floors.dmi';
	icon_state = "floor"
	},
/area/shuttle/transport)
"L" = (
/obj/machinery/door/airlock/shuttle{
	id_tag = "s_docking_airlock";
	req_access = list(31,105,63)
	},
/obj/structure/fans/tiny,
/turf/simulated/floor/noslip{
	icon = 'icons/turf/shuttle/floors.dmi';
	icon_state = "floor"
	},
/area/shuttle/transport)
"N" = (
/obj/machinery/door/window/survival_pod{
	dir = 1;
	layer = 3;
	req_access = list(104,106,63,19)
	},
/mob/living/simple_animal/hostile/hellhound{
	faction = list("neutral")
	},
/obj/structure/window/reinforced/survival_pod/unhittable{
	dir = 8;
	pixel_x = -4;
	damage_deflection = 100
	},
/turf/simulated/floor{
	dir = 1;
	icon_state = "darkgreycamo"
	},
/area/shuttle/transport)
"O" = (
/obj/structure/table/reinforced,
/obj/machinery/recharger,
/turf/simulated/floor/noslip{
	icon = 'icons/turf/shuttle/floors.dmi';
	icon_state = "floor"
	},
/area/shuttle/transport)
"P" = (
/obj/structure/closet/crate/freezer,
/obj/item/grenade/clusterbuster/meat,
/obj/item/reagent_containers/food/snacks/meat,
/obj/item/reagent_containers/food/snacks/meat,
/obj/item/reagent_containers/food/snacks/meat,
/obj/item/reagent_containers/food/snacks/meat,
/obj/item/reagent_containers/food/snacks/meat,
/obj/machinery/light/spot{
	dir = 1;
	tag = "icon-tube1 (NORTH)"
	},
/obj/structure/window/reinforced/survival_pod/unhittable{
	dir = 8;
	pixel_x = -4;
	damage_deflection = 100
	},
/turf/simulated/floor/noslip{
	icon = 'icons/turf/shuttle/floors.dmi';
	icon_state = "floor"
	},
/area/shuttle/transport)
"Q" = (
/obj/machinery/door/window/survival_pod{
	dir = 2;
	layer = 3;
	req_access = list(104,106,63,19)
	},
/obj/structure/window/plasmareinforced{
	dir = 8;
	layer = 2.9
	},
/mob/living/simple_animal/pet/penguin/emperor{
	faction = list("neutral")
	},
/turf/simulated/floor{
	icon_state = "darkgreycamo"
	},
/area/shuttle/transport)
"R" = (
/obj/structure/closet/crate/freezer,
/obj/item/reagent_containers/food/snacks/grown/pineapple,
/obj/item/reagent_containers/food/snacks/grown/pineapple,
/obj/item/reagent_containers/food/snacks/grown/redbeet,
/obj/item/reagent_containers/food/snacks/grown/redbeet,
/obj/item/reagent_containers/food/snacks/grown/redbeet,
/obj/item/reagent_containers/food/snacks/grown/sugarcane,
/obj/item/reagent_containers/food/snacks/grown/sugarcane,
/obj/item/reagent_containers/food/snacks/grown/sugarcane,
/obj/item/reagent_containers/food/snacks/grown/banana,
/obj/item/reagent_containers/food/snacks/grown/banana,
/obj/item/reagent_containers/food/snacks/grown/banana,
/obj/item/reagent_containers/food/snacks/grown/banana,
/obj/machinery/light/spot,
/obj/structure/window/reinforced/survival_pod/unhittable{
	dir = 8;
	pixel_x = -4;
	damage_deflection = 100
	},
/turf/simulated/floor/noslip{
	icon = 'icons/turf/shuttle/floors.dmi';
	icon_state = "floor"
	},
/area/shuttle/transport)
"T" = (
/obj/machinery/door/window/survival_pod{
	dir = 2;
	layer = 3;
	req_access = list(104,106,63,19)
	},
/obj/structure/window/reinforced/survival_pod/unhittable{
	dir = 8;
	pixel_x = -4;
	damage_deflection = 100
	},
/turf/simulated/floor{
	icon_state = "darkgreycamo"
	},
/area/shuttle/transport)
"W" = (
/obj/machinery/door/window/survival_pod{
	dir = 1;
	layer = 3;
	req_access = list(104,106,63,19)
	},
/obj/structure/window/reinforced/survival_pod/unhittable{
	dir = 8;
	pixel_x = -4;
	damage_deflection = 100
	},
/turf/simulated/floor{
	dir = 1;
	icon_state = "darkgreycamo"
	},
/area/shuttle/transport)
"Z" = (
/obj/machinery/door/window/survival_pod{
	dir = 2;
	layer = 3;
	req_access = list(104,106,63,19)
	},
/mob/living/simple_animal/pet/penguin/emperor{
	faction = list("neutral")
	},
/obj/structure/window/reinforced/survival_pod/unhittable{
	dir = 8;
	pixel_x = -4;
	damage_deflection = 100
	},
/turf/simulated/floor{
	icon_state = "darkgreycamo"
	},
/area/shuttle/transport)

(1,1,1) = {"
a
a
L
a
a
"}
(2,1,1) = {"
G
Q
l
o
G
"}
(3,1,1) = {"
G
Z
l
D
G
"}
(4,1,1) = {"
G
b
l
W
G
"}
(5,1,1) = {"
G
T
l
N
G
"}
(6,1,1) = {"
G
T
l
W
G
"}
(7,1,1) = {"
G
i
l
W
G
"}
(8,1,1) = {"
G
T
l
w
G
"}
(9,1,1) = {"
G
P
l
R
G
"}
(10,1,1) = {"
G
H
l
m
G
"}
(11,1,1) = {"
G
O
l
J
G
"}
(12,1,1) = {"
G
u
F
u
G
"}
