//MAP CONVERTED BY dmm2tgm.py THIS HEADER COMMENT PREVENTS RECONVERSION, DO NOT REMOVE
"a" = (
/obj/structure/shuttle/engine/propulsion{
	dir = 8;
	tag = "icon-propulsion (EAST)"
	},
/turf/simulated/floor/shuttle/plating,
/area/shuttle/transport)
"b" = (
/obj/structure/chair/comfy/shuttle,
/turf/simulated/floor/mineral/titanium,
/area/shuttle/transport)
"d" = (
/obj/structure/chair/comfy/shuttle{
	dir = 1
	},
/turf/simulated/floor/mineral/titanium,
/area/shuttle/transport)
"g" = (
/obj/structure/statue/tranquillite/mime,
/obj/structure/chair/comfy/shuttle{
	dir = 1
	},
/turf/simulated/floor/mineral/titanium,
/area/shuttle/transport)
"i" = (
/obj/structure/window/full/shuttle,
/obj/structure/grille,
/turf/simulated/floor/shuttle/plating,
/area/shuttle/transport)
"j" = (
/obj/structure/rack,
/obj/item/storage/box/syndie_kit/mimery{
	pixel_x = -4;
	pixel_y = 4
	},
/obj/item/storage/box/syndie_kit/mimery,
/obj/item/storage/box/syndie_kit/mimery{
	pixel_x = 4;
	pixel_y = -4
	},
/turf/simulated/floor/mineral/titanium,
/area/shuttle/transport)
"p" = (
/obj/docking_port/mobile{
	dir = 8;
	dwidth = 2;
	height = 12;
	id = "ferry";
	name = "ferry shuttle";
	roundstart_move = "ferry_away";
	timid = 1;
	width = 5
	},
/obj/structure/fans/tiny,
/obj/machinery/door/airlock/tranquillite{
	glass = 1;
	req_access = list(46)
	},
/turf/simulated/floor/shuttle,
/area/shuttle/transport)
"u" = (
/obj/structure/chair/comfy/shuttle,
/obj/structure/statue/tranquillite/mime,
/turf/simulated/floor/mineral/titanium,
/area/shuttle/transport)
"w" = (
/obj/structure/window/plasmareinforced{
	dir = 8;
	layer = 2.9
	},
/obj/structure/shuttle/engine/heater{
	dir = 4
	},
/obj/structure/window/plasmareinforced{
	dir = 4
	},
/obj/item/stack/sheet/mineral/tranquillite,
/turf/simulated/floor/shuttle/plating,
/area/shuttle/transport)
"y" = (
/obj/machinery/vending/autodrobe,
/turf/simulated/floor/mineral/titanium,
/area/shuttle/transport)
"z" = (
/turf/simulated/floor/mineral/tranquillite,
/area/shuttle/transport)
"B" = (
/obj/structure/statue/tranquillite/mime,
/obj/structure/chair/comfy/shuttle,
/turf/simulated/floor/mineral/titanium,
/area/shuttle/transport)
"C" = (
/obj/structure/table/reinforced,
/obj/item/phone{
	name = "НЕконспиративнный телефон"
	},
/obj/item/reagent_containers/food/snacks/baguette,
/obj/item/lipstick/random{
	pixel_x = -3;
	pixel_y = -3
	},
/obj/item/lipstick/random{
	pixel_x = -1;
	pixel_y = 1
	},
/obj/item/lipstick/random{
	pixel_x = 3;
	pixel_y = 3
	},
/obj/machinery/light/spot{
	dir = 1
	},
/turf/simulated/floor/mineral/titanium,
/area/shuttle/transport)
"F" = (
/turf/simulated/wall/shuttle,
/area/shuttle/transport)
"N" = (
/turf/simulated/floor/mineral/titanium,
/area/shuttle/transport)
"U" = (
/obj/structure/chair/comfy/shuttle{
	dir = 1
	},
/obj/machinery/light/spot,
/turf/simulated/floor/mineral/titanium,
/area/shuttle/transport)
"W" = (
/obj/machinery/computer/shuttle/ferry/request{
	dir = 4
	},
/turf/simulated/floor/mineral/tranquillite,
/area/shuttle/transport)

(1,1,1) = {"
a
a
a
a
a
"}
(2,1,1) = {"
F
w
w
w
F
"}
(3,1,1) = {"
F
y
W
y
F
"}
(4,1,1) = {"
F
N
z
N
F
"}
(5,1,1) = {"
F
u
z
U
F
"}
(6,1,1) = {"
F
u
z
g
F
"}
(7,1,1) = {"
F
b
z
d
F
"}
(8,1,1) = {"
F
C
z
j
F
"}
(9,1,1) = {"
F
u
z
d
F
"}
(10,1,1) = {"
F
b
z
g
F
"}
(11,1,1) = {"
F
B
z
g
F
"}
(12,1,1) = {"
F
i
p
i
F
"}
